Code,Country,Sub Region,Continent,Year,Invertebrates,Vertebrates,Plants,Total
450,Madagascar,Eastern Africa,Africa,2021,244,583,2837,3664
450,Madagascar,Eastern Africa,Africa,2020,195,556,2159,2910
840,United States of America,Northern America,North America,2019,581,479,556,1616
840,United States of America,Northern America,North America,2018,580,462,498,1540
840,United States of America,Northern America,North America,2015,575,444,280,1299
840,United States of America,Northern America,North America,2004,561,342,240,1143
218,Ecuador,South America,South America,2021,76,501,1991,2568
218,Ecuador,South America,South America,2020,70,470,1961,2501
36,Australia,Australia and New Zealand,Oceania,2019,545,363,108,1016
36,Australia,Australia and New Zealand,Oceania,2018,534,358,106,998
840,United States of America,Northern America,North America,2010,531,376,245,1152
36,Australia,Australia and New Zealand,Oceania,2015,514,304,91,909
36,Australia,Australia and New Zealand,Oceania,2010,489,297,67,853
484,Mexico,Central America,North America,2021,117,805,1156,2078
360,Indonesia,South-eastern Asia,Asia,2021,366,805,817,1988
458,Malaysia,South-eastern Asia,Asia,2021,320,400,1208,1928
360,Indonesia,South-eastern Asia,Asia,2019,336,627,509,1472
840,United States of America,Northern America,North America,2021,600,506,735,1841
36,Australia,Australia and New Zealand,Oceania,2021,556,457,760,1773
690,Seychelles,Eastern Africa,Africa,2019,321,64,61,446
76,Brazil,South America,South America,2021,78,509,1118,1705
458,Malaysia,South-eastern Asia,Asia,2020,314,351,997,1662
690,Seychelles,Eastern Africa,Africa,2018,320,58,61,439
690,Seychelles,Eastern Africa,Africa,2015,319,54,62,435
484,Mexico,Central America,North America,2020,114,751,791,1656
840,United States of America,Northern America,North America,2020,586,482,587,1655
300,Greece,Southern Europe,Europe,2018,308,123,71,502
300,Greece,Southern Europe,Europe,2019,308,124,80,512
360,Indonesia,South-eastern Asia,Asia,2020,364,663,627,1654
170,Colombia,South America,South America,2021,63,666,726,1455
360,Indonesia,South-eastern Asia,Asia,2015,290,530,426,1246
834,United Rep. of Tanzania,Eastern Africa,Africa,2021,148,407,867,1422
724,Spain,Southern Europe,Europe,2018,288,142,251,681
724,Spain,Southern Europe,Europe,2019,288,142,306,736
360,Indonesia,South-eastern Asia,Asia,2018,287,572,436,1295
36,Australia,Australia and New Zealand,Oceania,2004,283,282,56,621
458,Malaysia,South-eastern Asia,Asia,2019,282,343,813,1438
458,Malaysia,South-eastern Asia,Asia,2018,265,280,712,1257
458,Malaysia,South-eastern Asia,Asia,2015,262,269,721,1252
360,Indonesia,South-eastern Asia,Asia,2010,246,503,393,1142
608,Philippines,South-eastern Asia,Asia,2021,339,338,653,1330
458,Malaysia,South-eastern Asia,Asia,2010,242,246,692,1180
608,Philippines,South-eastern Asia,Asia,2019,240,284,259,783
36,Australia,Australia and New Zealand,Oceania,2020,548,433,327,1308
608,Philippines,South-eastern Asia,Asia,2018,238,302,245,785
608,Philippines,South-eastern Asia,Asia,2015,237,291,239,767
156,China,Eastern Asia,Asia,2021,85,544,679,1308
834,United Rep. of Tanzania,Eastern Africa,Africa,2020,147,386,726,1259
380,Italy,Southern Europe,Europe,2018,222,89,109,420
380,Italy,Southern Europe,Europe,2019,222,91,145,458
724,Spain,Southern Europe,Europe,2015,215,123,213,551
608,Philippines,South-eastern Asia,Asia,2010,213,262,222,697
356,India,Southern Asia,Asia,2021,139,594,460,1193
156,China,Eastern Asia,Asia,2020,84,451,637,1172
764,Thailand,South-eastern Asia,Asia,2019,212,275,168,655
764,Thailand,South-eastern Asia,Asia,2015,211,234,150,595
764,Thailand,South-eastern Asia,Asia,2018,211,255,155,621
710,South Africa,Southern Africa,Africa,2018,208,248,151,607
710,South Africa,Southern Africa,Africa,2019,208,242,153,603
356,India,Southern Asia,Asia,2020,138,550,430,1118
620,Portugal,Southern Europe,Europe,2019,205,101,150,456
76,Brazil,South America,South America,2020,66,416,596,1078
710,South Africa,Southern Africa,Africa,2015,202,209,116,527
620,Portugal,Southern Europe,Europe,2018,197,98,104,399
170,Colombia,South America,South America,2020,56,615,354,1025
450,Madagascar,Eastern Africa,Africa,2019,195,554,1624,2373
120,Cameroon,Middle Africa,Africa,2021,28,285,704,1017
450,Madagascar,Eastern Africa,Africa,2018,194,551,871,1616
598,Papua New Guinea,Melanesia,Oceania,2021,190,255,571,1016
604,Peru,South America,South America,2021,11,413,495,919
764,Thailand,South-eastern Asia,Asia,2010,185,201,91,477
120,Cameroon,Middle Africa,Africa,2020,26,272,592,890
540,New Caledonia,Melanesia,Oceania,2021,130,127,629,886
598,Papua New Guinea,Melanesia,Oceania,2015,181,146,151,478
598,Papua New Guinea,Melanesia,Oceania,2018,180,161,158,499
598,Papua New Guinea,Melanesia,Oceania,2019,178,166,186,530
608,Philippines,South-eastern Asia,Asia,2020,323,293,268,884
604,Peru,South America,South America,2020,9,396,414,819
704,Viet Nam,South-eastern Asia,Asia,2021,156,357,290,803
392,Japan,Eastern Asia,Asia,2019,176,223,60,459
392,Japan,Eastern Asia,Asia,2018,174,198,50,422
702,Singapore,South-eastern Asia,Asia,2015,173,56,58,287
702,Singapore,South-eastern Asia,Asia,2018,173,67,60,300
702,Singapore,South-eastern Asia,Asia,2019,173,77,62,312
710,South Africa,Southern Africa,Africa,2021,207,271,314,792
598,Papua New Guinea,Melanesia,Oceania,2010,171,139,143,453
392,Japan,Eastern Asia,Asia,2015,170,171,23,364
242,Fiji,Melanesia,Oceania,2015,165,48,65,278
242,Fiji,Melanesia,Oceania,2018,165,55,78,298
242,Fiji,Melanesia,Oceania,2019,165,57,78,300
724,Spain,Southern Europe,Europe,2021,294,158,325,777
702,Singapore,South-eastern Asia,Asia,2010,162,58,57,277
250,France,Western Europe,Europe,2018,160,84,55,299
250,France,Western Europe,Europe,2019,160,84,98,342
862,Venezuela (Boliv. Rep. of),South America,South America,2021,41,332,392,765
710,South Africa,Southern Africa,Africa,2010,159,185,97,441
392,Japan,Eastern Asia,Asia,2010,157,158,15,330
540,New Caledonia,Melanesia,Oceania,2020,129,120,510,759
724,Spain,Southern Europe,Europe,2020,290,143,319,752
704,Viet Nam,South-eastern Asia,Asia,2019,154,310,236,700
704,Viet Nam,South-eastern Asia,Asia,2018,152,278,231,661
90,Solomon Islands,Melanesia,Oceania,2015,151,70,17,238
90,Solomon Islands,Melanesia,Oceania,2018,151,75,16,242
90,Solomon Islands,Melanesia,Oceania,2019,150,77,16,243
764,Thailand,South-eastern Asia,Asia,2021,213,318,215,746
704,Viet Nam,South-eastern Asia,Asia,2020,156,322,260,738
144,Sri Lanka,Southern Asia,Asia,2021,129,253,298,680
764,Thailand,South-eastern Asia,Asia,2020,213,279,182,674
144,Sri Lanka,Southern Asia,Asia,2020,130,213,298,641
834,United Rep. of Tanzania,Eastern Africa,Africa,2019,147,366,661,1174
404,Kenya,Eastern Africa,Africa,2021,93,196,326,615
585,Palau,Micronesia,Oceania,2015,146,27,4,177
585,Palau,Micronesia,Oceania,2018,146,34,4,184
585,Palau,Micronesia,Oceania,2019,146,35,5,186
90,Solomon Islands,Melanesia,Oceania,2010,141,63,16,220
710,South Africa,Southern Africa,Africa,2020,196,247,154,597
598,Papua New Guinea,Melanesia,Oceania,2020,183,173,229,585
356,India,Southern Asia,Asia,2019,136,546,399,1081
380,Italy,Southern Europe,Europe,2015,136,76,67,279
356,India,Southern Asia,Asia,2015,135,520,384,1039
356,India,Southern Asia,Asia,2018,135,540,392,1067
250,France,Western Europe,Europe,2015,133,70,33,236
144,Sri Lanka,Southern Asia,Asia,2015,130,159,291,580
144,Sri Lanka,Southern Asia,Asia,2018,130,172,294,596
180,Dem. Rep. of the Congo,Middle Africa,Africa,2021,54,222,295,571
392,Japan,Eastern Asia,Asia,2021,190,303,69,562
404,Kenya,Eastern Africa,Africa,2020,93,179,277,549
144,Sri Lanka,Southern Asia,Asia,2019,129,175,298,602
320,Guatemala,Central America,North America,2021,13,254,269,536
158,Other non-specified areas,No Categorization,No Categorization,2019,129,134,87,350
300,Greece,Southern Europe,Europe,2021,308,135,84,527
300,Greece,Southern Europe,Europe,2020,309,127,84,520
834,United Rep. of Tanzania,Eastern Africa,Africa,2015,129,346,602,1077
834,United Rep. of Tanzania,Eastern Africa,Africa,2018,129,360,632,1121
158,Other non-specified areas,No Categorization,No Categorization,2015,128,114,83,325
158,Other non-specified areas,No Categorization,No Categorization,2018,128,129,85,342
704,Viet Nam,South-eastern Asia,Asia,2015,127,239,199,565
710,South Africa,Southern Africa,Africa,2004,127,155,75,357
188,Costa Rica,Central America,North America,2021,33,249,235,517
540,New Caledonia,Melanesia,Oceania,2015,125,109,259,493
540,New Caledonia,Melanesia,Oceania,2018,125,117,350,592
540,New Caledonia,Melanesia,Oceania,2019,125,118,350,593
620,Portugal,Southern Europe,Europe,2021,239,119,154,512
158,Other non-specified areas,No Categorization,No Categorization,2010,122,104,78,304
300,Greece,Southern Europe,Europe,2015,122,111,58,291
480,Mauritius,Eastern Africa,Africa,2019,121,54,91,266
591,Panama,Central America,North America,2021,24,254,219,497
144,Sri Lanka,Southern Asia,Asia,2010,120,149,283,552
480,Mauritius,Eastern Africa,Africa,2018,120,48,91,259
480,Mauritius,Eastern Africa,Africa,2015,118,41,90,249
180,Dem. Rep. of the Congo,Middle Africa,Africa,2020,54,203,240,497
380,Italy,Southern Europe,Europe,2021,223,107,165,495
583,Micronesia (Fed. States of),Micronesia,Oceania,2015,115,44,4,163
508,Mozambique,Eastern Africa,Africa,2021,67,172,254,493
583,Micronesia (Fed. States of),Micronesia,Oceania,2018,114,50,4,168
583,Micronesia (Fed. States of),Micronesia,Oceania,2019,114,49,5,168
356,India,Southern Asia,Asia,2010,113,390,255,758
484,Mexico,Central America,North America,2019,113,736,529,1378
450,Madagascar,Eastern Africa,Africa,2015,110,446,409,965
583,Micronesia (Fed. States of),Micronesia,Oceania,2010,108,35,5,148
484,Mexico,Central America,North America,2018,106,657,450,1213
585,Palau,Micronesia,Oceania,2010,102,22,4,128
450,Madagascar,Eastern Africa,Africa,2010,100,283,280,663
690,Seychelles,Eastern Africa,Africa,2010,100,45,45,190
480,Mauritius,Eastern Africa,Africa,2010,98,36,88,222
540,New Caledonia,Melanesia,Oceania,2010,97,61,257,415
380,Italy,Southern Europe,Europe,2020,223,95,164,482
392,Japan,Eastern Asia,Asia,2020,177,228,65,470
620,Portugal,Southern Europe,Europe,2015,94,81,81,256
620,Portugal,Southern Europe,Europe,2020,205,106,154,465
266,Gabon,Middle Africa,Africa,2021,4,121,334,459
484,Mexico,Central America,North America,2015,93,639,377,1109
404,Kenya,Eastern Africa,Africa,2019,92,176,248,516
548,Vanuatu,Melanesia,Oceania,2015,92,35,10,137
690,Seychelles,Eastern Africa,Africa,2021,322,74,61,457
704,Viet Nam,South-eastern Asia,Asia,2010,92,186,146,424
250,France,Western Europe,Europe,2010,91,62,15,168
548,Vanuatu,Melanesia,Oceania,2018,91,38,10,139
548,Vanuatu,Melanesia,Oceania,2019,91,39,10,140
690,Seychelles,Eastern Africa,Africa,2020,321,68,62,451
242,Fiji,Melanesia,Oceania,2010,90,37,65,192
68,Bolivia (Plurin. State of),South America,South America,2021,3,154,290,447
638,RÃ©union,Eastern Africa,Africa,2018,89,24,18,131
638,RÃ©union,Eastern Africa,Africa,2019,89,29,19,137
792,Turkey,Western Asia,Asia,2021,87,216,139,442
792,Turkey,Western Asia,Asia,2020,88,209,138,435
404,Kenya,Eastern Africa,Africa,2018,87,169,234,490
638,RÃ©union,Eastern Africa,Africa,2015,87,22,17,126
508,Mozambique,Eastern Africa,Africa,2020,65,153,208,426
792,Turkey,Western Asia,Asia,2019,86,208,132,426
807,North Macedonia,Southern Europe,Europe,2018,86,34,5,125
807,North Macedonia,Southern Europe,Europe,2019,86,34,7,127
158,Other non-specified areas,No Categorization,No Categorization,2021,130,189,90,409
340,Honduras,Central America,North America,2021,21,233,155,409
104,Myanmar,South-eastern Asia,Asia,2021,77,235,96,408
792,Turkey,Western Asia,Asia,2018,85,201,114,400
332,Haiti,Caribbean,North America,2021,14,186,208,408
404,Kenya,Eastern Africa,Africa,2015,84,157,222,463
566,Nigeria,Western Africa,Africa,2021,15,170,218,403
591,Panama,Central America,North America,2020,22,170,208,400
192,Cuba,Caribbean,North America,2021,23,177,188,388
705,Slovenia,Southern Europe,Europe,2018,83,53,11,147
705,Slovenia,Southern Europe,Europe,2019,83,53,26,162
250,France,Western Europe,Europe,2021,160,103,119,382
620,Portugal,Southern Europe,Europe,2004,82,51,15,148
296,Kiribati,Micronesia,Oceania,2015,81,19,0,100
296,Kiribati,Micronesia,Oceania,2018,81,23,0,104
296,Kiribati,Micronesia,Oceania,2019,81,24,0,105
324,Guinea,Western Africa,Africa,2021,11,175,194,380
566,Nigeria,Western Africa,Africa,2020,13,156,211,380
862,Venezuela (Boliv. Rep. of),South America,South America,2020,26,251,102,379
834,United Rep. of Tanzania,Eastern Africa,Africa,2010,80,313,298,691
116,Cambodia,South-eastern Asia,Asia,2018,79,145,37,261
116,Cambodia,South-eastern Asia,Asia,2019,79,154,39,272
250,France,Western Europe,Europe,2020,162,88,116,366
324,Guinea,Western Africa,Africa,2020,8,168,189,365
156,China,Eastern Asia,Asia,2019,79,441,604,1124
191,Croatia,Southern Europe,Europe,2018,79,93,9,181
191,Croatia,Southern Europe,Europe,2019,79,93,25,197
484,Mexico,Central America,North America,2010,79,609,255,943
548,Vanuatu,Melanesia,Oceania,2010,79,32,10,121
620,Portugal,Southern Europe,Europe,2010,79,71,21,171
188,Costa Rica,Central America,North America,2020,31,181,151,363
158,Other non-specified areas,No Categorization,No Categorization,2020,129,144,89,362
798,Tuvalu,Polynesia,Oceania,2015,78,15,0,93
798,Tuvalu,Polynesia,Oceania,2018,78,18,0,96
798,Tuvalu,Polynesia,Oceania,2019,78,20,0,98
104,Myanmar,South-eastern Asia,Asia,2020,77,200,80,357
104,Myanmar,South-eastern Asia,Asia,2015,77,163,61,301
104,Myanmar,South-eastern Asia,Asia,2018,77,187,61,325
104,Myanmar,South-eastern Asia,Asia,2019,77,197,63,337
192,Cuba,Caribbean,North America,2020,23,155,179,357
320,Guatemala,Central America,North America,2020,13,189,150,352
116,Cambodia,South-eastern Asia,Asia,2015,77,130,36,243
174,Comoros,Eastern Africa,Africa,2019,77,37,9,123
702,Singapore,South-eastern Asia,Asia,2021,177,107,66,350
340,Honduras,Central America,North America,2020,21,181,140,342
380,Italy,Southern Europe,Europe,2010,77,70,27,174
156,China,Eastern Asia,Asia,2015,76,420,544,1040
156,China,Eastern Asia,Asia,2018,76,431,588,1095
174,Comoros,Eastern Africa,Africa,2018,76,34,9,119
388,Jamaica,Caribbean,North America,2021,15,111,215,341
705,Slovenia,Southern Europe,Europe,2015,76,42,7,125
792,Turkey,Western Asia,Asia,2015,76,191,103,370
40,Austria,Western Europe,Europe,2018,74,28,25,127
40,Austria,Western Europe,Europe,2019,74,28,68,170
242,Fiji,Melanesia,Oceania,2021,182,66,90,338
887,Yemen,Western Asia,Asia,2021,68,97,164,329
376,Israel,Western Asia,Asia,2015,74,78,0,152
376,Israel,Western Asia,Asia,2018,74,91,23,188
376,Israel,Western Asia,Asia,2019,74,103,28,205
266,Gabon,Middle Africa,Africa,2020,4,110,215,329
702,Singapore,South-eastern Asia,Asia,2020,177,83,66,326
388,Jamaica,Caribbean,North America,2020,15,94,214,323
242,Fiji,Melanesia,Oceania,2020,172,62,87,321
174,Comoros,Eastern Africa,Africa,2015,73,26,7,106
296,Kiribati,Micronesia,Oceania,2010,73,17,0,90
584,Marshall Islands,Micronesia,Oceania,2015,73,22,0,95
584,Marshall Islands,Micronesia,Oceania,2018,73,28,0,101
584,Marshall Islands,Micronesia,Oceania,2019,73,28,0,101
32,Argentina,South America,South America,2021,19,210,91,320
638,RÃ©union,Eastern Africa,Africa,2010,73,16,15,104
96,Brunei Darussalam,South-eastern Asia,Asia,2021,18,130,169,317
175,Mayotte,Eastern Africa,Africa,2019,72,22,4,98
887,Yemen,Western Asia,Asia,2020,68,82,163,313
116,Cambodia,South-eastern Asia,Asia,2021,79,182,45,306
404,Kenya,Eastern Africa,Africa,2010,72,137,129,338
8,Albania,Southern Europe,Europe,2018,71,62,4,137
8,Albania,Southern Europe,Europe,2019,71,61,5,137
384,CÃ´te dÂ’Ivoire,Western Africa,Africa,2021,10,148,140,298
68,Bolivia (Plurin. State of),South America,South America,2020,3,131,162,296
798,Tuvalu,Polynesia,Oceania,2010,71,14,0,85
643,Russian Federation,Eastern Europe,Europe,2021,37,155,103,295
175,Mayotte,Eastern Africa,Africa,2018,70,19,3,92
218,Ecuador,South America,South America,2018,70,434,1864,2368
218,Ecuador,South America,South America,2019,70,441,1882,2393
32,Argentina,South America,South America,2020,15,194,76,285
40,Austria,Western Europe,Europe,2015,69,24,13,106
86,British Indian Ocean Terr.,Eastern Africa,Africa,2015,69,11,1,81
86,British Indian Ocean Terr.,Eastern Africa,Africa,2018,69,15,1,85
86,British Indian Ocean Terr.,Eastern Africa,Africa,2019,69,18,1,88
90,Solomon Islands,Melanesia,Oceania,2021,150,95,38,283
175,Mayotte,Eastern Africa,Africa,2015,69,15,0,84
504,Morocco,Northern Africa,Africa,2018,69,105,49,223
504,Morocco,Northern Africa,Africa,2019,69,103,55,227
116,Cambodia,South-eastern Asia,Asia,2020,79,160,41,280
656,Tristan da Cunha,Oceania,Oceania,2019,69,,45,156
807,North Macedonia,Southern Europe,Europe,2015,69,31,0,100
520,Nauru,Micronesia,Oceania,2015,68,12,0,80
520,Nauru,Micronesia,Oceania,2018,68,14,0,82
520,Nauru,Micronesia,Oceania,2019,68,15,0,83
384,CÃ´te dÂ’Ivoire,Western Africa,Africa,2020,7,140,133,280
642,Romania,Eastern Europe,Europe,2018,68,50,7,125
654,Saint Helena,Western Africa,Africa,2019,68,42,45,155
887,Yemen,Western Asia,Asia,2015,68,57,162,287
887,Yemen,Western Asia,Asia,2018,68,72,163,303
887,Yemen,Western Asia,Asia,2019,68,78,163,309
480,Mauritius,Eastern Africa,Africa,2021,126,61,92,279
643,Russian Federation,Eastern Europe,Europe,2020,38,141,100,279
116,Cambodia,South-eastern Asia,Asia,2010,67,107,30,204
191,Croatia,Southern Europe,Europe,2015,67,84,8,159
508,Mozambique,Eastern Africa,Africa,2015,67,117,84,268
508,Mozambique,Eastern Africa,Africa,2018,67,132,122,321
152,Chile,South America,South America,2021,14,154,107,275
584,Marshall Islands,Micronesia,Oceania,2010,67,17,0,84
642,Romania,Eastern Europe,Europe,2019,67,51,20,138
96,Brunei Darussalam,South-eastern Asia,Asia,2020,18,97,160,275
480,Mauritius,Eastern Africa,Africa,2020,124,56,92,272
724,Spain,Southern Europe,Europe,2010,67,118,55,240
288,Ghana,Western Africa,Africa,2021,12,135,124,271
800,Uganda,Eastern Africa,Africa,2021,31,131,107,269
332,Haiti,Caribbean,North America,2020,14,161,94,269
16,American Samoa,Polynesia,Oceania,2019,65,29,1,95
418,Lao People's Dem. Rep.,South-eastern Asia,Asia,2021,21,174,72,267
86,British Indian Ocean Terr.,Eastern Africa,Africa,2010,65,10,1,76
218,Ecuador,South America,South America,2015,65,395,1848,2308
250,France,Western Europe,Europe,2004,65,53,2,120
258,French Polynesia,Polynesia,Oceania,2015,65,63,47,175
800,Uganda,Eastern Africa,Africa,2020,31,128,107,266
508,Mozambique,Eastern Africa,Africa,2019,65,142,170,377
554,New Zealand,Australia and New Zealand,Oceania,2021,61,170,34,265
876,Wallis and Futuna Islands,Polynesia,Oceania,2015,65,22,1,88
554,New Zealand,Australia and New Zealand,Oceania,2020,61,166,34,261
16,American Samoa,Polynesia,Oceania,2015,64,25,1,90
16,American Samoa,Polynesia,Oceania,2018,64,27,1,92
76,Brazil,South America,South America,2019,64,411,582,1057
104,Myanmar,South-eastern Asia,Asia,2010,64,143,42,249
876,Wallis and Futuna Islands,Polynesia,Oceania,2018,64,24,1,89
876,Wallis and Futuna Islands,Polynesia,Oceania,2019,64,24,1,89
694,Sierra Leone,Western Africa,Africa,2021,12,125,122,259
90,Solomon Islands,Melanesia,Oceania,2020,150,82,24,256
288,Ghana,Western Africa,Africa,2020,5,128,122,255
504,Morocco,Northern Africa,Africa,2021,71,121,62,254
174,Comoros,Eastern Africa,Africa,2010,63,21,5,89
724,Spain,Southern Europe,Europe,2004,63,76,14,153
882,Samoa,Polynesia,Oceania,2019,63,30,2,95
218,Ecuador,South America,South America,2010,62,356,1837,2255
258,French Polynesia,Polynesia,Oceania,2018,62,66,48,176
258,French Polynesia,Polynesia,Oceania,2019,62,67,48,177
520,Nauru,Micronesia,Oceania,2010,62,12,0,74
706,Somalia,Eastern Africa,Africa,2015,62,60,43,165
706,Somalia,Eastern Africa,Africa,2018,62,71,46,179
706,Somalia,Eastern Africa,Africa,2019,62,76,49,187
214,Dominican Republic,Caribbean,North America,2021,19,152,80,251
418,Lao People's Dem. Rep.,South-eastern Asia,Asia,2020,21,166,63,250
882,Samoa,Polynesia,Oceania,2015,62,26,2,90
882,Samoa,Polynesia,Oceania,2018,62,29,2,93
887,Yemen,Western Asia,Asia,2010,62,48,159,269
276,Germany,Western Europe,Europe,2018,61,40,43,144
276,Germany,Western Europe,Europe,2019,61,41,83,185
430,Liberia,Western Africa,Africa,2021,12,132,104,248
152,Chile,South America,South America,2020,13,140,87,240
504,Morocco,Northern Africa,Africa,2020,71,106,61,238
400,Jordan,Western Asia,Asia,2015,61,40,1,102
400,Jordan,Western Asia,Asia,2018,61,48,8,117
400,Jordan,Western Asia,Asia,2019,61,55,8,124
694,Sierra Leone,Western Africa,Africa,2020,8,111,117,236
376,Israel,Western Asia,Asia,2021,74,120,40,234
554,New Zealand,Australia and New Zealand,Oceania,2018,61,131,24,216
554,New Zealand,Australia and New Zealand,Oceania,2019,61,162,24,247
226,Equatorial Guinea,Middle Africa,Africa,2021,4,110,120,234
558,Nicaragua,Central America,North America,2021,20,142,64,226
175,Mayotte,Eastern Africa,Africa,2010,60,9,0,69
316,Guam,Micronesia,Oceania,2015,60,31,4,95
316,Guam,Micronesia,Oceania,2018,60,35,4,99
316,Guam,Micronesia,Oceania,2019,60,38,5,103
191,Croatia,Southern Europe,Europe,2021,80,104,35,219
682,Saudi Arabia,Western Asia,Asia,2019,60,77,4,141
430,Liberia,Western Africa,Africa,2020,10,122,86,218
706,Somalia,Eastern Africa,Africa,2021,62,99,56,217
258,French Polynesia,Polynesia,Oceania,2010,59,54,47,160
508,Mozambique,Eastern Africa,Africa,2010,59,98,52,209
682,Saudi Arabia,Western Asia,Asia,2015,59,57,3,119
682,Saudi Arabia,Western Asia,Asia,2018,59,69,4,132
705,Slovenia,Southern Europe,Europe,2010,59,36,0,95
807,North Macedonia,Southern Europe,Europe,2010,59,31,0,90
8,Albania,Southern Europe,Europe,2015,58,54,0,112
232,Eritrea,Eastern Africa,Africa,2015,58,51,4,113
232,Eritrea,Eastern Africa,Africa,2018,58,67,5,130
232,Eritrea,Eastern Africa,Africa,2019,58,74,6,138
191,Croatia,Southern Europe,Europe,2020,80,97,35,212
376,Israel,Western Asia,Asia,2020,74,105,28,207
376,Israel,Western Asia,Asia,2010,58,73,0,131
380,Italy,Southern Europe,Europe,2004,58,53,3,114
276,Germany,Western Europe,Europe,2021,61,46,98,205
226,Equatorial Guinea,Middle Africa,Africa,2020,4,94,107,205
16,American Samoa,Polynesia,Oceania,2010,57,21,1,79
100,Bulgaria,Eastern Europe,Europe,2018,57,49,9,115
100,Bulgaria,Eastern Europe,Europe,2019,57,49,18,124
214,Dominican Republic,Caribbean,North America,2020,19,136,48,203
262,Djibouti,Eastern Africa,Africa,2015,57,34,3,94
262,Djibouti,Eastern Africa,Africa,2018,57,43,3,103
262,Djibouti,Eastern Africa,Africa,2019,57,49,3,109
50,Bangladesh,Southern Asia,Asia,2021,7,163,31,201
276,Germany,Western Europe,Europe,2020,61,42,97,200
276,Germany,Western Europe,Europe,2015,57,33,17,107
580,Northern Mariana Islands,Micronesia,Oceania,2015,57,37,5,99
580,Northern Mariana Islands,Micronesia,Oceania,2019,57,39,6,102
586,Pakistan,Southern Asia,Asia,2021,18,164,18,200
706,Somalia,Eastern Africa,Africa,2020,62,84,53,199
585,Palau,Micronesia,Oceania,2021,149,42,5,196
876,Wallis and Futuna Islands,Polynesia,Oceania,2010,57,16,1,74
258,French Polynesia,Polynesia,Oceania,2021,66,73,56,195
108,Burundi,Eastern Africa,Africa,2021,6,51,137,194
818,Egypt,Northern Africa,Africa,2018,56,99,8,163
818,Egypt,Northern Africa,Africa,2019,56,105,8,169
40,Austria,Western Europe,Europe,2010,55,23,4,82
76,Brazil,South America,South America,2018,55,407,538,1000
170,Colombia,South America,South America,2019,55,581,280,916
180,Dem. Rep. of the Congo,Middle Africa,Africa,2018,55,187,148,390
818,Egypt,Northern Africa,Africa,2015,55,83,3,141
76,Brazil,South America,South America,2015,54,396,516,966
180,Dem. Rep. of the Congo,Middle Africa,Africa,2019,54,188,185,427
24,Angola,Middle Africa,Africa,2021,11,134,48,193
818,Egypt,Northern Africa,Africa,2021,57,126,8,191
170,Colombia,South America,South America,2018,53,537,261,851
180,Dem. Rep. of the Congo,Middle Africa,Africa,2015,53,171,109,333
682,Saudi Arabia,Western Asia,Asia,2010,53,47,3,103
882,Samoa,Polynesia,Oceania,2010,53,23,2,78
504,Morocco,Northern Africa,Africa,2015,52,90,34,176
180,Dem. Rep. of the Congo,Middle Africa,Africa,2010,51,162,83,296
580,Northern Mariana Islands,Micronesia,Oceania,2010,51,29,5,85
706,Somalia,Eastern Africa,Africa,2010,51,56,21,128
585,Palau,Micronesia,Oceania,2020,148,36,5,189
232,Eritrea,Eastern Africa,Africa,2010,50,44,3,97
262,Djibouti,Eastern Africa,Africa,2010,50,29,2,81
729,Sudan,Northern Africa,Africa,2015,50,57,16,123
729,Sudan,Northern Africa,Africa,2018,50,73,17,140
729,Sudan,Northern Africa,Africa,2019,50,82,19,151
654,Saint Helena,Western Africa,Africa,2021,97,46,46,189
656,Tristan da Cunha,Oceania,Oceania,2021,97,,46,189
218,Ecuador,South America,South America,2004,48,288,1815,2151
400,Jordan,Western Asia,Asia,2010,48,41,1,90
40,Austria,Western Europe,Europe,2021,74,30,84,188
8,Albania,Southern Europe,Europe,2010,47,53,0,100
581,U.S. Minor Outlying islands,Micronesia,Oceania,2015,47,24,0,71
581,U.S. Minor Outlying islands,Micronesia,Oceania,2018,47,26,0,73
581,U.S. Minor Outlying islands,Micronesia,Oceania,2019,47,24,0,71
108,Burundi,Eastern Africa,Africa,2020,6,48,134,188
756,Switzerland,Western Europe,Europe,2018,47,22,10,79
756,Switzerland,Western Europe,Europe,2019,47,22,43,112
40,Austria,Western Europe,Europe,2020,74,28,83,185
422,Lebanon,Western Asia,Asia,2021,18,67,100,185
776,Tonga,Polynesia,Oceania,2015,47,23,4,74
776,Tonga,Polynesia,Oceania,2018,47,28,5,80
776,Tonga,Polynesia,Oceania,2019,47,28,5,80
462,Maldives,Southern Asia,Asia,2015,46,23,0,69
462,Maldives,Southern Asia,Asia,2018,46,29,0,75
462,Maldives,Southern Asia,Asia,2019,46,33,0,79
554,New Zealand,Australia and New Zealand,Oceania,2015,46,130,21,197
818,Egypt,Northern Africa,Africa,2010,46,73,2,121
76,Brazil,South America,South America,2010,45,341,387,773
392,Japan,Eastern Asia,Asia,2004,45,148,12,205
231,Ethiopia,Eastern Africa,Africa,2021,15,103,65,183
583,Micronesia (Fed. States of),Micronesia,Oceania,2021,121,53,8,182
729,Sudan,Northern Africa,Africa,2010,45,49,18,112
40,Austria,Western Europe,Europe,2004,44,20,3,67
581,U.S. Minor Outlying islands,Micronesia,Oceania,2010,44,23,0,67
705,Slovenia,Southern Europe,Europe,2021,84,65,33,182
258,French Polynesia,Polynesia,Oceania,2020,65,68,48,181
826,United Kingdom,Northern Europe,Europe,2021,20,71,90,181
756,Switzerland,Western Europe,Europe,2015,43,15,4,62
178,Congo,Middle Africa,Africa,2021,7,101,73,181
124,Canada,Northern America,North America,2021,39,95,46,180
70,Bosnia and Herzegovina,Southern Europe,Europe,2018,42,50,3,95
70,Bosnia and Herzegovina,Southern Europe,Europe,2019,42,50,6,98
499,Montenegro,Southern Europe,Europe,2018,42,56,3,101
499,Montenegro,Southern Europe,Europe,2019,42,55,7,104
231,Ethiopia,Eastern Africa,Africa,2020,15,101,64,180
705,Slovenia,Southern Europe,Europe,2004,42,32,0,74
484,Mexico,Central America,North America,2004,41,446,261,748
826,United Kingdom,Northern Europe,Europe,2020,20,67,89,176
12,Algeria,Northern Africa,Africa,2018,40,80,23,143
12,Algeria,Northern Africa,Africa,2019,40,81,24,145
504,Morocco,Northern Africa,Africa,2010,40,86,31,157
705,Slovenia,Southern Europe,Europe,2020,84,58,33,175
462,Maldives,Southern Asia,Asia,2010,39,20,0,59
643,Russian Federation,Eastern Europe,Europe,2018,39,139,60,238
124,Canada,Northern America,North America,2019,38,93,37,168
364,Iran (Islamic Republic of),Southern Asia,Asia,2021,23,138,14,175
642,Romania,Eastern Europe,Europe,2015,38,42,5,85
643,Russian Federation,Eastern Europe,Europe,2019,38,139,90,267
84,Belize,Central America,North America,2021,12,93,69,174
804,Ukraine,Eastern Europe,Europe,2018,38,53,23,114
804,Ukraine,Eastern Europe,Europe,2019,38,53,36,127
654,Saint Helena,Western Africa,Africa,2020,83,45,45,173
124,Canada,Northern America,North America,2020,38,95,40,173
100,Bulgaria,Eastern Europe,Europe,2015,37,42,6,85
124,Canada,Northern America,North America,2018,37,86,25,148
818,Egypt,Northern Africa,Africa,2020,57,107,8,172
70,Bosnia and Herzegovina,Southern Europe,Europe,2015,36,48,1,85
300,Greece,Southern Europe,Europe,2010,36,107,13,156
643,Russian Federation,Eastern Europe,Europe,2015,36,126,55,217
646,Rwanda,Eastern Africa,Africa,2021,4,54,113,171
348,Hungary,Eastern Europe,Europe,2015,35,22,10,67
688,Serbia,Southern Europe,Europe,2018,35,35,7,77
688,Serbia,Southern Europe,Europe,2019,35,35,14,84
24,Angola,Middle Africa,Africa,2020,11,117,43,171
772,Tokelau,Polynesia,Oceania,2015,35,11,0,46
772,Tokelau,Polynesia,Oceania,2018,35,14,0,49
772,Tokelau,Polynesia,Oceania,2019,35,16,0,51
583,Micronesia (Fed. States of),Micronesia,Oceania,2020,116,49,5,170
776,Tonga,Polynesia,Oceania,2010,35,19,4,58
76,Brazil,South America,South America,2004,34,282,381,697
276,Germany,Western Europe,Europe,2010,34,33,12,79
348,Hungary,Eastern Europe,Europe,2018,34,26,45,105
499,Montenegro,Southern Europe,Europe,2015,34,49,2,85
12,Algeria,Northern Africa,Africa,2021,42,96,32,170
170,Colombia,South America,South America,2015,33,473,245,751
646,Rwanda,Eastern Africa,Africa,2020,4,52,112,168
729,Sudan,Northern Africa,Africa,2021,50,97,18,165
348,Hungary,Eastern Europe,Europe,2019,33,27,59,119
760,Syrian Arab Republic,Western Asia,Asia,2021,22,99,44,165
50,Bangladesh,Southern Asia,Asia,2020,7,133,25,165
654,Saint Helena,Western Africa,Africa,2018,33,41,44,118
834,United Rep. of Tanzania,Eastern Africa,Africa,2004,33,144,239,416
156,China,Eastern Asia,Asia,2010,32,374,453,859
184,Cook Islands,Polynesia,Oceania,2015,32,30,11,73
184,Cook Islands,Polynesia,Oceania,2018,32,32,11,75
184,Cook Islands,Polynesia,Oceania,2019,32,32,11,75
686,Senegal,Western Africa,Africa,2021,16,124,22,162
450,Madagascar,Eastern Africa,Africa,2004,32,222,276,530
480,Mauritius,Eastern Africa,Africa,2004,32,28,87,147
410,Republic of Korea,Eastern Asia,Asia,2021,8,113,40,161
703,Slovakia,Eastern Europe,Europe,2018,32,21,28,81
703,Slovakia,Eastern Europe,Europe,2019,32,21,54,107
364,Iran (Islamic Republic of),Southern Asia,Asia,2020,24,125,12,161
188,Costa Rica,Central America,North America,2018,31,171,144,346
188,Costa Rica,Central America,North America,2019,31,176,144,351
558,Nicaragua,Central America,North America,2020,20,89,52,161
276,Germany,Western Europe,Europe,2004,31,35,12,78
360,Indonesia,South-eastern Asia,Asia,2004,31,419,383,833
512,Oman,Western Asia,Asia,2015,31,53,6,90
512,Oman,Western Asia,Asia,2018,31,68,6,105
512,Oman,Western Asia,Asia,2019,31,71,6,108
682,Saudi Arabia,Western Asia,Asia,2021,60,96,4,160
630,Puerto Rico,Caribbean,North America,2021,0,90,69,159
729,Sudan,Northern Africa,Africa,2020,50,89,19,158
772,Tokelau,Polynesia,Oceania,2010,31,10,0,41
12,Algeria,Northern Africa,Africa,2020,42,85,28,155
586,Pakistan,Southern Asia,Asia,2020,18,124,13,155
178,Congo,Middle Africa,Africa,2020,7,92,56,155
232,Eritrea,Eastern Africa,Africa,2021,58,90,6,154
170,Colombia,South America,South America,2010,30,424,227,681
188,Costa Rica,Central America,North America,2015,30,162,131,323
570,Niue,Polynesia,Oceania,2015,30,20,0,50
570,Niue,Polynesia,Oceania,2018,30,22,0,52
570,Niue,Polynesia,Oceania,2019,30,23,0,53
328,Guyana,South America,South America,2021,1,112,39,152
643,Russian Federation,Eastern Europe,Europe,2004,30,114,7,151
756,Switzerland,Western Europe,Europe,2004,30,17,2,49
800,Uganda,Eastern Africa,Africa,2018,30,124,64,218
800,Uganda,Eastern Africa,Africa,2019,30,126,83,239
203,Czechia,Eastern Europe,Europe,2018,29,14,31,74
203,Czechia,Eastern Europe,Europe,2019,29,14,51,94
638,RÃ©union,Eastern Africa,Africa,2021,90,40,21,151
548,Vanuatu,Melanesia,Oceania,2021,92,48,10,150
258,French Polynesia,Polynesia,Oceania,2004,29,46,47,122
60,Bermuda,Northern America,North America,2010,28,18,4,50
60,Bermuda,Northern America,North America,2015,28,28,8,64
60,Bermuda,Northern America,North America,2018,28,36,8,72
60,Bermuda,Northern America,North America,2019,28,39,8,75
8,Albania,Southern Europe,Europe,2021,72,70,5,147
499,Montenegro,Southern Europe,Europe,2010,28,44,0,72
616,Poland,Eastern Europe,Europe,2018,28,24,14,66
616,Poland,Eastern Europe,Europe,2019,28,23,32,83
760,Syrian Arab Republic,Western Asia,Asia,2020,23,92,32,147
630,Puerto Rico,Caribbean,North America,2020,0,79,67,146
756,Switzerland,Western Europe,Europe,2010,28,14,3,45
100,Bulgaria,Eastern Europe,Europe,2010,27,39,0,66
120,Cameroon,Middle Africa,Africa,2015,27,237,433,697
188,Costa Rica,Central America,North America,2010,27,142,116,285
404,Kenya,Eastern Africa,Africa,2004,27,99,103,229
12,Algeria,Northern Africa,Africa,2015,26,71,17,114
638,RÃ©union,Eastern Africa,Africa,2020,89,35,21,145
348,Hungary,Eastern Europe,Europe,2010,26,20,1,47
512,Oman,Western Asia,Asia,2010,26,47,6,79
862,Venezuela (Boliv. Rep. of),South America,South America,2015,26,209,77,312
862,Venezuela (Boliv. Rep. of),South America,South America,2018,26,228,81,335
862,Venezuela (Boliv. Rep. of),South America,South America,2019,26,231,90,347
686,Senegal,Western Africa,Africa,2020,13,109,23,145
60,Bermuda,Northern America,North America,2004,25,18,4,47
120,Cameroon,Middle Africa,Africa,2018,25,263,544,832
120,Cameroon,Middle Africa,Africa,2019,25,268,559,852
184,Cook Islands,Polynesia,Oceania,2010,25,27,1,53
348,Hungary,Eastern Europe,Europe,2004,25,25,1,51
643,Russian Federation,Eastern Europe,Europe,2010,25,93,8,126
120,Cameroon,Middle Africa,Africa,2010,24,222,378,624
203,Czechia,Eastern Europe,Europe,2015,24,11,10,45
364,Iran (Islamic Republic of),Southern Asia,Asia,2015,24,94,3,121
364,Iran (Islamic Republic of),Southern Asia,Asia,2018,24,111,5,140
364,Iran (Islamic Republic of),Southern Asia,Asia,2019,24,118,10,152
548,Vanuatu,Melanesia,Oceania,2020,91,42,11,144
682,Saudi Arabia,Western Asia,Asia,2020,60,80,4,144
642,Romania,Eastern Europe,Europe,2010,24,39,1,64
192,Cuba,Caribbean,North America,2015,23,138,176,337
192,Cuba,Caribbean,North America,2018,23,146,179,348
192,Cuba,Caribbean,North America,2019,23,151,180,354
642,Romania,Eastern Europe,Europe,2021,67,55,22,144
232,Eritrea,Eastern Africa,Africa,2020,58,79,6,143
356,India,Southern Asia,Asia,2004,23,283,246,552
222,El Salvador,Central America,North America,2021,10,79,54,143
570,Niue,Polynesia,Oceania,2010,23,20,0,43
574,Norfolk Island,Australia and New Zealand,Oceania,2015,23,17,1,41
574,Norfolk Island,Australia and New Zealand,Oceania,2018,23,19,2,44
574,Norfolk Island,Australia and New Zealand,Oceania,2019,23,21,2,46
84,Belize,Central America,North America,2020,12,78,53,143
8,Albania,Southern Europe,Europe,2020,73,64,5,142
642,Romania,Eastern Europe,Europe,2020,67,51,22,140
804,Ukraine,Eastern Europe,Europe,2015,23,47,17,87
70,Bosnia and Herzegovina,Southern Europe,Europe,2010,22,44,1,67
124,Canada,Northern America,North America,2015,22,68,7,97
180,Dem. Rep. of the Congo,Middle Africa,Africa,2004,22,84,65,171
591,Panama,Central America,North America,2015,22,148,203,373
591,Panama,Central America,North America,2018,22,154,211,387
591,Panama,Central America,North America,2019,22,161,211,394
780,Trinidad and Tobago,Caribbean,North America,2021,10,79,50,139
616,Poland,Eastern Europe,Europe,2015,22,19,10,51
642,Romania,Eastern Europe,Europe,2004,22,40,1,63
688,Serbia,Southern Europe,Europe,2015,22,29,5,56
703,Slovakia,Eastern Europe,Europe,2015,22,16,7,45
760,Syrian Arab Republic,Western Asia,Asia,2018,22,91,26,139
760,Syrian Arab Republic,Western Asia,Asia,2019,22,91,31,144
454,Malawi,Eastern Africa,Africa,2021,15,76,46,137
12,Algeria,Northern Africa,Africa,2010,21,69,15,105
174,Comoros,Eastern Africa,Africa,2021,77,46,13,136
191,Croatia,Southern Europe,Europe,2010,21,77,3,101
340,Honduras,Central America,North America,2018,21,157,131,309
340,Honduras,Central America,North America,2019,21,163,134,318
858,Uruguay,South America,South America,2021,3,111,22,136
410,Republic of Korea,Eastern Asia,Asia,2020,8,90,38,136
418,Lao People's Dem. Rep.,South-eastern Asia,Asia,2015,21,148,41,210
418,Lao People's Dem. Rep.,South-eastern Asia,Asia,2018,21,149,54,224
418,Lao People's Dem. Rep.,South-eastern Asia,Asia,2019,21,164,58,243
807,North Macedonia,Southern Europe,Europe,2021,86,35,13,134
804,Ukraine,Eastern Europe,Europe,2021,38,55,41,134
574,Norfolk Island,Australia and New Zealand,Oceania,2010,21,19,1,41
807,North Macedonia,Southern Europe,Europe,2020,86,34,13,133
804,Ukraine,Eastern Europe,Europe,2020,38,53,41,132
862,Venezuela (Boliv. Rep. of),South America,South America,2010,21,179,70,270
516,Namibia,Southern Africa,Africa,2021,4,97,31,132
166,Cocos (Keeling) Islands,Australia and New Zealand,Oceania,2015,20,11,0,31
166,Cocos (Keeling) Islands,Australia and New Zealand,Oceania,2018,20,13,0,33
166,Cocos (Keeling) Islands,Australia and New Zealand,Oceania,2019,20,17,0,37
756,Switzerland,Western Europe,Europe,2021,47,24,60,131
558,Nicaragua,Central America,North America,2018,20,79,50,149
558,Nicaragua,Central America,North America,2019,20,84,49,153
454,Malawi,Eastern Africa,Africa,2020,14,74,42,130
756,Switzerland,Western Europe,Europe,2020,47,22,59,128
591,Panama,Central America,North America,2010,20,125,202,347
760,Syrian Arab Republic,Western Asia,Asia,2015,20,84,4,108
788,Tunisia,Northern Africa,Africa,2018,20,71,10,101
788,Tunisia,Northern Africa,Africa,2019,20,71,10,101
826,United Kingdom,Northern Europe,Europe,2019,20,66,78,164
174,Comoros,Eastern Africa,Africa,2020,77,41,9,127
100,Bulgaria,Eastern Europe,Europe,2020,57,49,21,127
400,Jordan,Western Asia,Asia,2021,61,58,8,127
162,Christmas Island,Australia and New Zealand,Oceania,2018,19,18,1,38
162,Christmas Island,Australia and New Zealand,Oceania,2019,19,22,1,42
100,Bulgaria,Eastern Europe,Europe,2021,56,50,21,127
203,Czechia,Eastern Europe,Europe,2004,19,22,4,45
203,Czechia,Eastern Europe,Europe,2010,19,10,4,33
512,Oman,Western Asia,Asia,2021,32,89,6,127
348,Hungary,Eastern Europe,Europe,2021,33,30,63,126
364,Iran (Islamic Republic of),Southern Asia,Asia,2010,19,82,1,102
268,Georgia,Western Asia,Asia,2020,15,42,69,126
458,Malaysia,South-eastern Asia,Asia,2004,19,190,683,892
608,Philippines,South-eastern Asia,Asia,2004,19,225,212,456
703,Slovakia,Eastern Europe,Europe,2004,19,27,2,48
800,Uganda,Eastern Africa,Africa,2004,19,77,38,134
800,Uganda,Eastern Africa,Africa,2015,19,117,52,188
826,United Kingdom,Northern Europe,Europe,2018,19,64,48,131
891,Serbia and Monten. [former],Southern Europe,Europe,2004,19,42,1,62
780,Trinidad and Tobago,Caribbean,North America,2020,10,66,50,126
268,Georgia,Western Asia,Asia,2021,14,41,69,124
162,Christmas Island,Australia and New Zealand,Oceania,2015,18,18,1,37
214,Dominican Republic,Caribbean,North America,2019,18,133,49,200
340,Honduras,Central America,North America,2015,18,156,120,294
422,Lebanon,Western Asia,Asia,2018,18,57,24,99
422,Lebanon,Western Asia,Asia,2019,18,57,29,104
716,Zimbabwe,Eastern Africa,Africa,2021,8,43,73,124
558,Nicaragua,Central America,North America,2015,18,79,44,141
586,Pakistan,Southern Asia,Asia,2015,18,99,12,129
586,Pakistan,Southern Asia,Asia,2018,18,115,12,145
586,Pakistan,Southern Asia,Asia,2019,18,118,12,148
348,Hungary,Eastern Europe,Europe,2020,33,27,63,123
132,Cabo Verde,Western Africa,Africa,2021,13,59,51,123
826,United Kingdom,Northern Europe,Europe,2015,18,53,16,87
166,Cocos (Keeling) Islands,Australia and New Zealand,Oceania,2010,17,11,0,28
716,Zimbabwe,Eastern Africa,Africa,2020,8,43,71,122
340,Honduras,Central America,North America,2010,17,110,113,240
368,Iraq,Western Asia,Asia,2015,17,51,1,69
368,Iraq,Western Asia,Asia,2018,17,54,2,73
368,Iraq,Western Asia,Asia,2019,17,58,3,78
328,Guyana,South America,South America,2020,1,86,35,122
454,Malawi,Eastern Africa,Africa,2010,17,127,14,158
558,Nicaragua,Central America,North America,2010,17,61,43,121
566,Nigeria,Western Africa,Africa,2015,17,127,189,333
400,Jordan,Western Asia,Asia,2020,61,52,8,121
703,Slovakia,Eastern Europe,Europe,2010,17,15,2,34
44,Bahamas,Caribbean,North America,2021,13,85,23,121
162,Christmas Island,Australia and New Zealand,Oceania,2010,16,16,1,33
894,Zambia,Eastern Africa,Africa,2021,13,63,45,121
524,Nepal,Southern Asia,Asia,2021,3,93,25,121
208,Denmark,Northern Europe,Europe,2018,16,29,4,49
208,Denmark,Northern Europe,Europe,2019,16,30,21,67
788,Tunisia,Northern Africa,Africa,2021,21,85,14,120
214,Dominican Republic,Caribbean,North America,2010,16,80,30,126
214,Dominican Republic,Caribbean,North America,2015,16,95,42,153
214,Dominican Republic,Caribbean,North America,2018,16,130,45,191
312,Guadeloupe,Caribbean,North America,2010,16,30,8,54
312,Guadeloupe,Caribbean,North America,2015,16,45,9,70
312,Guadeloupe,Caribbean,North America,2018,16,50,9,75
312,Guadeloupe,Caribbean,North America,2019,16,53,10,79
499,Montenegro,Southern Europe,Europe,2021,42,67,10,119
132,Cabo Verde,Western Africa,Africa,2020,13,55,51,119
51,Armenia,Western Asia,Asia,2020,9,34,76,119
422,Lebanon,Western Asia,Asia,2015,16,48,5,69
454,Malawi,Eastern Africa,Africa,2015,16,130,25,171
612,Pitcairn,Polynesia,Oceania,2015,16,20,7,43
612,Pitcairn,Polynesia,Oceania,2018,16,21,7,44
612,Pitcairn,Polynesia,Oceania,2019,16,19,7,42
262,Djibouti,Eastern Africa,Africa,2021,57,58,3,118
616,Poland,Eastern Europe,Europe,2010,16,17,4,37
638,RÃ©union,Eastern Africa,Africa,2004,16,18,14,48
578,Norway,Northern Europe,Europe,2021,9,47,62,118
688,Serbia,Southern Europe,Europe,2010,16,29,1,46
752,Sweden,Northern Europe,Europe,2018,16,27,15,58
752,Sweden,Northern Europe,Europe,2019,16,28,41,85
703,Slovakia,Eastern Europe,Europe,2021,31,22,64,117
516,Namibia,Southern Africa,Africa,2020,4,85,28,117
784,United Arab Emirates,Western Asia,Asia,2010,16,32,0,48
703,Slovakia,Eastern Europe,Europe,2020,32,21,63,116
56,Belgium,Western Europe,Europe,2018,15,23,1,39
56,Belgium,Western Europe,Europe,2019,15,23,17,55
51,Armenia,Western Asia,Asia,2021,8,32,76,116
192,Cuba,Caribbean,North America,2010,15,123,166,304
196,Cyprus,Western Asia,Asia,2018,15,42,21,78
196,Cyprus,Western Asia,Asia,2019,15,44,24,83
208,Denmark,Northern Europe,Europe,2015,15,20,1,36
231,Ethiopia,Eastern Africa,Africa,2010,15,79,26,120
231,Ethiopia,Eastern Africa,Africa,2015,15,89,41,145
231,Ethiopia,Eastern Africa,Africa,2018,15,95,47,157
231,Ethiopia,Eastern Africa,Africa,2019,15,99,64,178
678,Sao Tome and Principe,Middle Africa,Africa,2021,5,57,54,116
858,Uruguay,South America,South America,2020,2,92,22,116
268,Georgia,Western Asia,Asia,2015,15,38,61,114
268,Georgia,Western Asia,Asia,2018,15,42,63,120
268,Georgia,Western Asia,Asia,2019,15,42,68,125
578,Norway,Northern Europe,Europe,2020,10,44,61,115
368,Iraq,Western Asia,Asia,2010,15,45,0,60
388,Jamaica,Caribbean,North America,2010,15,58,209,282
388,Jamaica,Caribbean,North America,2015,15,69,214,298
388,Jamaica,Caribbean,North America,2018,15,87,214,316
388,Jamaica,Caribbean,North America,2019,15,91,215,321
204,Benin,Western Africa,Africa,2021,4,94,16,114
499,Montenegro,Southern Europe,Europe,2020,43,60,10,113
296,Kiribati,Micronesia,Oceania,2021,82,31,0,113
554,New Zealand,Australia and New Zealand,Oceania,2010,15,117,21,153
175,Mayotte,Eastern Africa,Africa,2021,72,31,10,113
586,Pakistan,Southern Asia,Asia,2010,15,92,2,109
612,Pitcairn,Polynesia,Oceania,2010,15,20,7,42
616,Poland,Eastern Europe,Europe,2004,15,27,4,46
752,Sweden,Northern Europe,Europe,2015,15,16,5,36
784,United Arab Emirates,Western Asia,Asia,2015,15,33,0,48
784,United Arab Emirates,Western Asia,Asia,2018,15,45,0,60
784,United Arab Emirates,Western Asia,Asia,2019,15,49,0,64
512,Oman,Western Asia,Asia,2020,31,75,6,112
740,Suriname,South America,South America,2021,1,80,31,112
788,Tunisia,Northern Africa,Africa,2015,15,61,7,83
792,Turkey,Western Asia,Asia,2010,15,130,5,150
800,Uganda,Eastern Africa,Africa,2010,15,110,41,166
804,Ukraine,Eastern Europe,Europe,2010,15,45,1,61
894,Zambia,Eastern Africa,Africa,2018,15,54,22,91
32,Argentina,South America,South America,2018,14,186,70,270
32,Argentina,South America,South America,2019,14,190,75,279
56,Belgium,Western Europe,Europe,2015,14,16,0,30
316,Guam,Micronesia,Oceania,2021,61,45,5,111
580,Northern Mariana Islands,Micronesia,Oceania,2021,58,47,6,111
478,Mauritania,Western Africa,Africa,2021,3,108,0,111
332,Haiti,Caribbean,North America,2010,14,94,29,137
332,Haiti,Caribbean,North America,2015,14,113,42,169
332,Haiti,Caribbean,North America,2018,14,153,80,247
332,Haiti,Caribbean,North America,2019,14,155,94,263
262,Djibouti,Eastern Africa,Africa,2020,57,50,3,110
64,Bhutan,Southern Asia,Asia,2021,1,58,51,110
454,Malawi,Eastern Africa,Africa,2018,14,136,26,176
454,Malawi,Eastern Africa,Africa,2019,14,74,37,125
422,Lebanon,Western Asia,Asia,2020,19,61,29,109
554,New Zealand,Australia and New Zealand,Oceania,2004,14,114,21,149
804,Ukraine,Eastern Europe,Europe,2004,14,40,1,55
894,Zambia,Eastern Africa,Africa,2010,14,44,9,67
894,Zambia,Eastern Africa,Africa,2015,14,49,20,83
894,Zambia,Eastern Africa,Africa,2019,14,56,28,98
584,Marshall Islands,Micronesia,Oceania,2021,74,35,0,109
32,Argentina,South America,South America,2015,13,160,70,243
882,Samoa,Polynesia,Oceania,2021,65,35,9,109
48,Bahrain,Western Asia,Asia,2010,13,19,0,32
48,Bahrain,Western Asia,Asia,2015,13,19,0,32
48,Bahrain,Western Asia,Asia,2018,13,27,0,40
48,Bahrain,Western Asia,Asia,2019,13,33,0,46
408,Dem. People's Rep. Korea,Eastern Asia,Asia,2021,4,84,21,109
524,Nepal,Southern Asia,Asia,2020,3,86,20,109
132,Cabo Verde,Western Africa,Africa,2015,13,35,3,51
132,Cabo Verde,Western Africa,Africa,2018,13,51,51,115
132,Cabo Verde,Western Africa,Africa,2019,13,53,51,117
296,Kiribati,Micronesia,Oceania,2020,81,27,0,108
254,French Guiana,South America,South America,2021,1,83,24,108
678,Sao Tome and Principe,Middle Africa,Africa,2020,4,55,49,108
152,Chile,South America,South America,2018,13,132,72,217
152,Chile,South America,South America,2019,13,135,76,224
316,Guam,Micronesia,Oceania,2020,60,42,5,107
320,Guatemala,Central America,North America,2018,13,175,113,301
320,Guatemala,Central America,North America,2019,13,185,123,321
788,Tunisia,Northern Africa,Africa,2020,21,74,12,107
894,Zambia,Eastern Africa,Africa,2020,14,61,32,107
414,Kuwait,Western Asia,Asia,2010,13,28,0,41
414,Kuwait,Western Asia,Asia,2015,13,29,0,42
414,Kuwait,Western Asia,Asia,2018,13,39,0,52
414,Kuwait,Western Asia,Asia,2019,13,43,0,56
70,Bosnia and Herzegovina,Southern Europe,Europe,2021,43,58,6,107
222,El Salvador,Central America,North America,2020,10,55,42,107
566,Nigeria,Western Africa,Africa,2018,13,148,203,364
566,Nigeria,Western Africa,Africa,2019,13,151,208,372
203,Czechia,Eastern Europe,Europe,2021,29,15,62,106
634,Qatar,Western Asia,Asia,2010,13,19,0,32
634,Qatar,Western Asia,Asia,2015,13,22,0,35
634,Qatar,Western Asia,Asia,2018,13,32,0,45
634,Qatar,Western Asia,Asia,2019,13,37,0,50
768,Togo,Western Africa,Africa,2021,5,88,13,106
204,Benin,Western Africa,Africa,2020,3,82,21,106
654,Saint Helena,Western Africa,Africa,2015,13,37,30,80
686,Senegal,Western Africa,Africa,2015,13,82,11,106
686,Senegal,Western Africa,Africa,2018,13,101,13,127
686,Senegal,Western Africa,Africa,2019,13,106,20,139
580,Northern Mariana Islands,Micronesia,Oceania,2020,57,42,6,105
752,Sweden,Northern Europe,Europe,2004,13,20,3,36
792,Turkey,Western Asia,Asia,2004,13,76,3,92
584,Marshall Islands,Micronesia,Oceania,2020,73,31,0,104
12,Algeria,Northern Africa,Africa,2004,12,36,2,50
32,Argentina,South America,South America,2010,12,157,44,213
44,Bahamas,Caribbean,North America,2015,12,61,8,81
44,Bahamas,Caribbean,North America,2018,12,71,7,90
44,Bahamas,Caribbean,North America,2019,12,71,12,95
70,Bosnia and Herzegovina,Southern Europe,Europe,2020,43,55,6,104
84,Belize,Central America,North America,2010,12,48,32,92
84,Belize,Central America,North America,2015,12,70,35,117
84,Belize,Central America,North America,2018,12,69,43,124
84,Belize,Central America,North America,2019,12,73,46,131
203,Czechia,Eastern Europe,Europe,2020,29,14,61,104
752,Sweden,Northern Europe,Europe,2021,16,31,57,104
96,Brunei Darussalam,South-eastern Asia,Asia,2019,12,93,131,236
124,Canada,Northern America,North America,2010,12,63,2,77
152,Chile,South America,South America,2015,12,98,72,182
208,Denmark,Northern Europe,Europe,2010,12,18,3,33
270,Gambia,Western Africa,Africa,2021,3,95,6,104
428,Latvia,Northern Europe,Europe,2015,12,13,0,25
428,Latvia,Northern Europe,Europe,2018,12,18,1,31
428,Latvia,Northern Europe,Europe,2019,12,18,5,35
175,Mayotte,Eastern Africa,Africa,2020,72,26,4,102
798,Tuvalu,Polynesia,Oceania,2021,79,23,0,102
16,American Samoa,Polynesia,Oceania,2021,66,34,2,102
624,Guinea-Bissau,Western Africa,Africa,2021,3,88,11,102
566,Nigeria,Western Africa,Africa,2010,12,113,172,297
574,Norfolk Island,Australia and New Zealand,Oceania,2004,12,21,1,34
598,Papua New Guinea,Melanesia,Oceania,2004,12,141,142,295
31,Azerbaijan,Western Asia,Asia,2020,7,49,46,102
24,Angola,Middle Africa,Africa,2018,11,108,35,154
24,Angola,Middle Africa,Africa,2019,11,111,36,158
64,Bhutan,Southern Asia,Asia,2020,1,55,45,101
882,Samoa,Polynesia,Oceania,2020,64,33,3,100
28,Antigua and Barbuda,Caribbean,North America,2010,11,23,4,38
28,Antigua and Barbuda,Caribbean,North America,2015,11,38,4,53
28,Antigua and Barbuda,Caribbean,North America,2018,11,41,4,56
28,Antigua and Barbuda,Caribbean,North America,2019,11,44,4,59
776,Tonga,Polynesia,Oceania,2021,58,35,7,100
31,Azerbaijan,Western Asia,Asia,2021,7,47,46,100
44,Bahamas,Caribbean,North America,2010,11,44,7,62
52,Barbados,Caribbean,North America,2015,11,37,3,51
52,Barbados,Caribbean,North America,2018,11,43,3,57
52,Barbados,Caribbean,North America,2019,11,44,3,58
798,Tuvalu,Polynesia,Oceania,2020,78,21,0,99
16,American Samoa,Polynesia,Oceania,2020,65,32,2,99
56,Belgium,Western Europe,Europe,2004,11,25,0,36
56,Belgium,Western Europe,Europe,2010,11,15,1,27
92,British Virgin Islands,Caribbean,North America,2021,10,65,24,99
124,Canada,Northern America,North America,2004,11,62,1,74
136,Cayman Islands,Caribbean,North America,2010,11,21,2,34
136,Cayman Islands,Caribbean,North America,2015,11,38,22,71
136,Cayman Islands,Caribbean,North America,2018,11,41,22,74
136,Cayman Islands,Caribbean,North America,2019,11,45,23,79
191,Croatia,Southern Europe,Europe,2004,11,46,0,57
208,Denmark,Northern Europe,Europe,2004,11,21,3,35
212,Dominica,Caribbean,North America,2010,11,27,10,48
212,Dominica,Caribbean,North America,2015,11,40,11,62
212,Dominica,Caribbean,North America,2018,11,44,11,66
212,Dominica,Caribbean,North America,2019,11,47,12,70
752,Sweden,Northern Europe,Europe,2020,16,29,53,98
44,Bahamas,Caribbean,North America,2020,12,72,12,96
300,Greece,Southern Europe,Europe,2004,11,62,2,75
616,Poland,Eastern Europe,Europe,2020,28,23,44,95
430,Liberia,Western Africa,Africa,2015,11,98,49,158
454,Malawi,Eastern Africa,Africa,2004,11,25,14,50
500,Montserrat,Caribbean,North America,2010,11,21,3,35
500,Montserrat,Caribbean,North America,2015,11,37,6,54
500,Montserrat,Caribbean,North America,2018,11,39,6,56
500,Montserrat,Caribbean,North America,2019,11,42,6,59
86,British Indian Ocean Terr.,Eastern Africa,Africa,2021,70,25,0,95
616,Poland,Eastern Europe,Europe,2021,28,23,44,95
528,Netherlands,Western Europe,Europe,2018,11,28,4,43
528,Netherlands,Western Europe,Europe,2019,11,29,19,59
312,Guadeloupe,Caribbean,North America,2021,16,67,12,95
530,Netherlands Antilles [former],Western Europe,Europe,2010,11,24,3,38
531,CuraÃ§ao,Caribbean,North America,2015,11,36,2,49
531,CuraÃ§ao,Caribbean,North America,2018,11,38,2,51
531,CuraÃ§ao,Caribbean,North America,2019,11,39,2,52
876,Wallis and Futuna Islands,Polynesia,Oceania,2021,64,29,1,94
478,Mauritania,Western Africa,Africa,2020,3,91,0,94
535,"Bonaire, St. Eustatius & Saba",Caribbean,North America,2015,11,41,3,55
535,"Bonaire, St. Eustatius & Saba",Caribbean,North America,2018,11,42,3,56
535,"Bonaire, St. Eustatius & Saba",Caribbean,North America,2019,11,44,3,58
768,Togo,Western Africa,Africa,2020,3,78,13,94
136,Cayman Islands,Caribbean,North America,2021,14,56,23,93
540,New Caledonia,Melanesia,Oceania,2004,11,34,217,262
876,Wallis and Futuna Islands,Polynesia,Oceania,2020,64,27,1,92
652,Saint BarthÃ©lemy,Caribbean,North America,2010,11,4,2,17
652,Saint BarthÃ©lemy,Caribbean,North America,2015,11,16,2,29
652,Saint BarthÃ©lemy,Caribbean,North America,2018,11,19,2,32
652,Saint BarthÃ©lemy,Caribbean,North America,2019,11,28,2,41
196,Cyprus,Western Asia,Asia,2021,16,52,24,92
344,"China, Hong Kong SAR",Eastern Asia,Asia,2021,10,68,14,92
662,Saint Lucia,Caribbean,North America,2010,11,29,6,46
662,Saint Lucia,Caribbean,North America,2015,11,41,6,58
662,Saint Lucia,Caribbean,North America,2018,11,45,6,62
662,Saint Lucia,Caribbean,North America,2019,11,48,8,67
624,Guinea-Bissau,Western Africa,Africa,2020,2,80,10,92
86,British Indian Ocean Terr.,Eastern Africa,Africa,2020,69,21,1,91
663,Saint Martin (French part),Caribbean,North America,2010,11,4,2,17
752,Sweden,Northern Europe,Europe,2010,11,15,3,29
788,Tunisia,Northern Africa,Africa,2010,11,57,7,75
826,United Kingdom,Northern Europe,Europe,2010,11,48,14,73
32,Argentina,South America,South America,2004,10,134,42,186
52,Barbados,Caribbean,North America,2010,10,24,2,36
70,Bosnia and Herzegovina,Southern Europe,Europe,2004,10,29,1,40
92,British Virgin Islands,Caribbean,North America,2010,10,23,10,43
92,British Virgin Islands,Caribbean,North America,2015,10,41,10,61
92,British Virgin Islands,Caribbean,North America,2018,10,48,20,78
92,British Virgin Islands,Caribbean,North America,2019,10,52,20,82
398,Kazakhstan,Central Asia,Asia,2021,7,70,14,91
776,Tonga,Polynesia,Oceania,2020,51,32,7,90
112,Belarus,Eastern Europe,Europe,2018,10,15,1,26
112,Belarus,Eastern Europe,Europe,2019,10,15,3,28
520,Nauru,Micronesia,Oceania,2021,69,21,0,90
222,El Salvador,Central America,North America,2018,10,47,30,87
222,El Salvador,Central America,North America,2019,10,50,33,93
92,British Virgin Islands,Caribbean,North America,2020,10,55,23,88
462,Maldives,Southern Asia,Asia,2021,45,43,0,88
246,Finland,Northern Europe,Europe,2004,10,14,1,25
246,Finland,Northern Europe,Europe,2015,10,13,2,25
246,Finland,Northern Europe,Europe,2018,10,19,8,37
246,Finland,Northern Europe,Europe,2019,10,19,21,50
368,Iraq,Western Asia,Asia,2021,16,68,4,88
212,Dominica,Caribbean,North America,2021,11,62,15,88
268,Georgia,Western Asia,Asia,2004,10,33,0,43
308,Grenada,Caribbean,North America,2010,10,24,3,37
308,Grenada,Caribbean,North America,2015,10,38,3,51
308,Grenada,Caribbean,North America,2018,10,42,3,55
308,Grenada,Caribbean,North America,2019,10,43,3,56
408,Dem. People's Rep. Korea,Eastern Asia,Asia,2020,3,66,19,88
740,Suriname,South America,South America,2020,1,58,29,88
688,Serbia,Southern Europe,Europe,2021,34,37,16,87
376,Israel,Western Asia,Asia,2004,10,47,0,57
850,United States Virgin Islands,Caribbean,North America,2021,0,66,21,87
430,Liberia,Western Africa,Africa,2018,10,112,53,175
430,Liberia,Western Africa,Africa,2019,10,114,83,207
270,Gambia,Western Africa,Africa,2020,2,78,7,87
528,Netherlands,Western Europe,Europe,2015,10,19,0,29
534,Sint Maarten (Dutch part),Caribbean,North America,2015,10,37,2,49
534,Sint Maarten (Dutch part),Caribbean,North America,2018,10,40,3,53
534,Sint Maarten (Dutch part),Caribbean,North America,2019,10,43,2,55
520,Nauru,Micronesia,Oceania,2020,68,18,0,86
688,Serbia,Southern Europe,Europe,2020,35,35,16,86
578,Norway,Northern Europe,Europe,2015,10,30,4,44
578,Norway,Northern Europe,Europe,2018,10,42,21,73
578,Norway,Northern Europe,Europe,2019,10,43,51,104
60,Bermuda,Northern America,North America,2021,30,48,8,86
659,Saint Kitts and Nevis,Caribbean,North America,2010,10,24,2,36
659,Saint Kitts and Nevis,Caribbean,North America,2015,10,39,2,51
659,Saint Kitts and Nevis,Caribbean,North America,2018,10,40,2,52
659,Saint Kitts and Nevis,Caribbean,North America,2019,10,43,2,55
434,Libya,Northern Africa,Africa,2021,5,72,9,86
662,Saint Lucia,Caribbean,North America,2021,11,63,11,85
660,Anguilla,Caribbean,North America,2010,10,20,3,33
660,Anguilla,Caribbean,North America,2015,10,37,4,51
660,Anguilla,Caribbean,North America,2018,10,40,4,54
660,Anguilla,Caribbean,North America,2019,10,43,4,57
196,Cyprus,Western Asia,Asia,2020,16,44,24,84
372,Ireland,Northern Europe,Europe,2021,6,51,27,84
663,Saint Martin (French part),Caribbean,North America,2015,10,38,3,51
663,Saint Martin (French part),Caribbean,North America,2018,10,40,3,53
663,Saint Martin (French part),Caribbean,North America,2019,10,43,3,56
312,Guadeloupe,Caribbean,North America,2020,16,57,10,83
136,Cayman Islands,Caribbean,North America,2020,13,47,23,83
670,Saint Vincent & Grenadines,Caribbean,North America,2010,10,24,4,38
670,Saint Vincent & Grenadines,Caribbean,North America,2015,10,39,5,54
670,Saint Vincent & Grenadines,Caribbean,North America,2018,10,44,5,59
670,Saint Vincent & Grenadines,Caribbean,North America,2019,10,45,6,61
344,"China, Hong Kong SAR",Eastern Asia,Asia,2020,9,63,11,83
140,Central African Republic,Middle Africa,Africa,2021,2,46,35,83
780,Trinidad and Tobago,Caribbean,North America,2010,10,37,1,48
780,Trinidad and Tobago,Caribbean,North America,2015,10,53,2,65
780,Trinidad and Tobago,Caribbean,North America,2018,10,58,50,118
780,Trinidad and Tobago,Caribbean,North America,2019,10,60,51,121
184,Cook Islands,Polynesia,Oceania,2021,33,36,13,82
208,Denmark,Northern Europe,Europe,2021,17,34,31,82
796,Turks and Caicos Islands,Caribbean,North America,2010,10,22,2,34
796,Turks and Caicos Islands,Caribbean,North America,2015,10,37,9,56
796,Turks and Caicos Islands,Caribbean,North America,2018,10,42,9,61
796,Turks and Caicos Islands,Caribbean,North America,2019,10,44,9,63
784,United Arab Emirates,Western Asia,Asia,2021,15,66,0,81
398,Kazakhstan,Central Asia,Asia,2020,7,59,15,81
826,United Kingdom,Northern Europe,Europe,2004,10,32,13,55
24,Angola,Middle Africa,Africa,2015,9,87,34,130
51,Armenia,Western Asia,Asia,2015,9,31,71,111
51,Armenia,Western Asia,Asia,2018,9,33,73,115
51,Armenia,Western Asia,Asia,2019,9,34,76,119
462,Maldives,Southern Asia,Asia,2020,45,35,0,80
96,Brunei Darussalam,South-eastern Asia,Asia,2018,9,82,116,207
100,Bulgaria,Eastern Europe,Europe,2004,9,35,0,44
112,Belarus,Eastern Europe,Europe,2015,9,11,1,21
152,Chile,South America,South America,2010,9,95,41,145
188,Costa Rica,Central America,North America,2004,9,112,110,231
268,Georgia,Western Asia,Asia,2010,9,37,0,46
320,Guatemala,Central America,North America,2015,9,176,97,282
344,"China, Hong Kong SAR",Eastern Asia,Asia,2019,9,51,10,70
60,Bermuda,Northern America,North America,2020,30,42,8,80
428,Latvia,Northern Europe,Europe,2010,9,9,0,18
430,Liberia,Western Africa,Africa,2010,9,91,47,147
578,Norway,Northern Europe,Europe,2004,9,22,2,33
368,Iraq,Western Asia,Asia,2020,17,59,4,80
604,Peru,South America,South America,2019,9,384,351,744
372,Ireland,Northern Europe,Europe,2020,6,46,27,79
20,Andorra,Southern Europe,Europe,2018,8,6,0,14
20,Andorra,Southern Europe,Europe,2019,8,6,1,15
254,French Guiana,South America,South America,2020,0,59,20,79
670,Saint Vincent & Grenadines,Caribbean,North America,2021,10,61,7,78
96,Brunei Darussalam,South-eastern Asia,Asia,2015,8,77,104,189
112,Belarus,Eastern Europe,Europe,2004,8,10,0,18
196,Cyprus,Western Asia,Asia,2015,8,34,18,60
184,Cook Islands,Polynesia,Oceania,2020,32,34,11,77
320,Guatemala,Central America,North America,2004,8,115,85,208
320,Guatemala,Central America,North America,2010,8,140,82,230
324,Guinea,Western Africa,Africa,2018,8,138,69,215
324,Guinea,Western Africa,Africa,2019,8,144,175,327
208,Denmark,Northern Europe,Europe,2020,16,31,30,77
344,"China, Hong Kong SAR",Eastern Asia,Asia,2015,8,45,7,60
344,"China, Hong Kong SAR",Eastern Asia,Asia,2018,8,49,8,65
410,Republic of Korea,Eastern Asia,Asia,2018,8,78,32,118
410,Republic of Korea,Eastern Asia,Asia,2019,8,82,35,125
535,"Bonaire, St. Eustatius & Saba",Caribbean,North America,2021,11,61,5,77
581,U.S. Minor Outlying islands,Micronesia,Oceania,2021,48,28,0,76
428,Latvia,Northern Europe,Europe,2004,8,15,0,23
440,Lithuania,Northern Europe,Europe,2018,8,18,2,28
440,Lithuania,Northern Europe,Europe,2019,8,18,9,35
308,Grenada,Caribbean,North America,2021,10,60,6,76
796,Turks and Caicos Islands,Caribbean,North America,2021,10,56,10,76
528,Netherlands,Western Europe,Europe,2021,12,34,29,75
504,Morocco,Northern Africa,Africa,2004,8,40,2,50
604,Peru,South America,South America,2015,8,317,318,643
604,Peru,South America,South America,2018,8,377,328,713
694,Sierra Leone,Western Africa,Africa,2015,8,92,58,158
694,Sierra Leone,Western Africa,Africa,2018,8,105,71,184
694,Sierra Leone,Western Africa,Africa,2019,8,110,111,229
434,Libya,Northern Africa,Africa,2020,5,62,8,75
716,Zimbabwe,Eastern Africa,Africa,2019,8,43,52,103
212,Dominica,Caribbean,North America,2020,11,51,12,74
52,Barbados,Caribbean,North America,2021,11,59,4,74
20,Andorra,Southern Europe,Europe,2015,7,4,0,11
474,Martinique,Caribbean,North America,2021,2,60,12,74
24,Angola,Middle Africa,Africa,2010,7,77,33,117
31,Azerbaijan,Western Asia,Asia,2015,7,43,42,92
31,Azerbaijan,Western Asia,Asia,2018,7,47,43,97
31,Azerbaijan,Western Asia,Asia,2019,7,49,45,101
850,United States Virgin Islands,Caribbean,North America,2020,0,54,20,74
581,U.S. Minor Outlying islands,Micronesia,Oceania,2020,47,26,0,73
50,Bangladesh,Southern Asia,Asia,2015,7,109,21,137
50,Bangladesh,Southern Asia,Asia,2018,7,125,22,154
50,Bangladesh,Southern Asia,Asia,2019,7,128,23,158
28,Antigua and Barbuda,Caribbean,North America,2021,11,60,2,73
140,Central African Republic,Middle Africa,Africa,2020,0,44,29,73
51,Armenia,Western Asia,Asia,2004,7,27,1,35
108,Burundi,Eastern Africa,Africa,2010,7,43,2,52
108,Burundi,Eastern Africa,Africa,2015,7,45,8,60
108,Burundi,Eastern Africa,Africa,2018,7,46,89,142
178,Congo,Middle Africa,Africa,2015,7,71,41,119
178,Congo,Middle Africa,Africa,2018,7,86,47,140
178,Congo,Middle Africa,Africa,2019,7,86,47,140
500,Montserrat,Caribbean,North America,2021,11,54,7,72
528,Netherlands,Western Europe,Europe,2020,11,31,29,71
222,El Salvador,Central America,North America,2015,7,47,29,83
233,Estonia,Northern Europe,Europe,2018,7,15,2,24
233,Estonia,Northern Europe,Europe,2019,7,15,17,39
531,CuraÃ§ao,Caribbean,North America,2021,11,56,4,71
246,Finland,Northern Europe,Europe,2010,7,10,1,18
324,Guinea,Western Africa,Africa,2015,7,122,34,163
384,CÃ´te dÂ’Ivoire,Western Africa,Africa,2018,7,133,117,257
384,CÃ´te dÂ’Ivoire,Western Africa,Africa,2019,7,134,129,270
466,Mali,Western Africa,Africa,2021,5,38,28,71
398,Kazakhstan,Central Asia,Asia,2015,7,55,16,78
398,Kazakhstan,Central Asia,Asia,2018,7,59,14,80
398,Kazakhstan,Central Asia,Asia,2019,7,59,15,81
600,Paraguay,South America,South America,2021,2,47,22,71
56,Belgium,Western Europe,Europe,2021,16,28,26,70
440,Lithuania,Northern Europe,Europe,2015,7,14,1,22
442,Luxembourg,Western Europe,Europe,2015,7,2,0,9
442,Luxembourg,Western Europe,Europe,2018,7,4,0,11
442,Luxembourg,Western Europe,Europe,2019,7,4,5,16
659,Saint Kitts and Nevis,Caribbean,North America,2021,10,56,4,70
732,Western Sahara,Northern Africa,Africa,2021,3,67,0,70
528,Netherlands,Western Europe,Europe,2004,7,27,0,34
578,Norway,Northern Europe,Europe,2010,7,27,2,36
716,Zimbabwe,Eastern Africa,Africa,2018,7,42,46,95
760,Syrian Arab Republic,Western Asia,Asia,2010,7,68,3,78
795,Turkmenistan,Central Asia,Asia,2015,7,38,4,49
795,Turkmenistan,Central Asia,Asia,2018,7,46,4,57
795,Turkmenistan,Central Asia,Asia,2019,7,48,4,59
784,United Arab Emirates,Western Asia,Asia,2020,15,54,0,69
662,Saint Lucia,Caribbean,North America,2020,11,50,8,69
894,Zambia,Eastern Africa,Africa,2004,7,24,8,39
24,Angola,Middle Africa,Africa,2004,6,44,26,76
31,Azerbaijan,Western Asia,Asia,2004,6,32,0,38
51,Armenia,Western Asia,Asia,2010,6,29,1,36
90,Solomon Islands,Melanesia,Oceania,2004,6,52,16,74
108,Burundi,Eastern Africa,Africa,2019,6,46,110,162
660,Anguilla,Caribbean,North America,2021,10,56,3,69
535,"Bonaire, St. Eustatius & Saba",Caribbean,North America,2020,11,50,6,67
112,Belarus,Eastern Europe,Europe,2010,6,10,0,16
600,Paraguay,South America,South America,2020,1,46,20,67
222,El Salvador,Central America,North America,2010,6,39,27,72
231,Ethiopia,Eastern Africa,Africa,2004,6,65,22,93
233,Estonia,Northern Europe,Europe,2015,6,11,0,17
56,Belgium,Western Europe,Europe,2020,15,25,26,66
670,Saint Vincent & Grenadines,Caribbean,North America,2020,10,50,5,65
316,Guam,Micronesia,Oceania,2010,6,24,4,34
344,"China, Hong Kong SAR",Eastern Asia,Asia,2010,6,37,6,49
372,Ireland,Northern Europe,Europe,2015,6,32,1,39
372,Ireland,Northern Europe,Europe,2018,6,42,5,53
372,Ireland,Northern Europe,Europe,2019,6,44,21,71
796,Turks and Caicos Islands,Caribbean,North America,2020,10,47,8,65
663,Saint Martin (French part),Caribbean,North America,2021,10,53,2,65
384,CÃ´te dÂ’Ivoire,Western Africa,Africa,2015,6,113,107,226
438,Liechtenstein,Western Europe,Europe,2018,6,2,0,8
438,Liechtenstein,Western Europe,Europe,2019,6,2,4,12
534,Sint Maarten (Dutch part),Caribbean,North America,2021,10,53,1,64
414,Kuwait,Western Asia,Asia,2021,13,50,0,63
498,Republic of Moldova,Eastern Europe,Europe,2018,6,26,2,34
498,Republic of Moldova,Eastern Europe,Europe,2019,6,25,2,33
52,Barbados,Caribbean,North America,2020,11,48,3,62
500,Montserrat,Caribbean,North America,2020,11,44,7,62
528,Netherlands,Western Europe,Europe,2010,6,18,0,24
694,Sierra Leone,Western Africa,Africa,2010,6,77,48,131
16,American Samoa,Polynesia,Oceania,2004,5,18,1,24
178,Congo,Middle Africa,Africa,2010,5,61,37,103
226,Equatorial Guinea,Middle Africa,Africa,2015,5,71,79,155
288,Ghana,Western Africa,Africa,2015,5,99,119,223
288,Ghana,Western Africa,Africa,2018,5,118,118,241
288,Ghana,Western Africa,Africa,2019,5,120,121,246
246,Finland,Northern Europe,Europe,2021,10,19,33,62
292,Gibraltar,Southern Europe,Europe,2015,5,21,0,26
292,Gibraltar,Southern Europe,Europe,2018,5,28,1,34
292,Gibraltar,Southern Europe,Europe,2019,5,27,1,33
316,Guam,Micronesia,Oceania,2004,5,16,3,24
324,Guinea,Western Africa,Africa,2010,5,107,22,134
388,Jamaica,Caribbean,North America,2004,5,54,208,267
422,Lebanon,Western Asia,Asia,2010,5,44,1,50
860,Uzbekistan,Central Asia,Asia,2021,3,44,15,62
728,South Sudan,Eastern Africa,Africa,2021,1,43,18,62
438,Liechtenstein,Western Europe,Europe,2004,5,3,0,8
860,Uzbekistan,Central Asia,Asia,2020,3,43,16,62
440,Lithuania,Northern Europe,Europe,2004,5,12,0,17
440,Lithuania,Northern Europe,Europe,2010,5,12,0,17
474,Martinique,Caribbean,North America,2020,2,51,9,62
470,Malta,Southern Europe,Europe,2018,5,30,4,39
470,Malta,Southern Europe,Europe,2019,5,31,4,40
498,Republic of Moldova,Eastern Europe,Europe,2004,5,22,0,27
498,Republic of Moldova,Eastern Europe,Europe,2015,5,22,2,29
508,Mozambique,Eastern Africa,Africa,2004,5,64,46,115
585,Palau,Micronesia,Oceania,2004,5,13,3,21
612,Pitcairn,Polynesia,Oceania,2004,5,15,7,27
678,Sao Tome and Principe,Middle Africa,Africa,2015,5,38,38,81
466,Mali,Western Africa,Africa,2020,0,37,25,62
716,Zimbabwe,Eastern Africa,Africa,2010,5,34,16,55
716,Zimbabwe,Eastern Africa,Africa,2015,5,38,17,60
28,Antigua and Barbuda,Caribbean,North America,2020,11,47,3,61
788,Tunisia,Northern Africa,Africa,2004,5,31,0,36
795,Turkmenistan,Central Asia,Asia,2004,5,35,0,40
795,Turkmenistan,Central Asia,Asia,2010,5,37,3,45
807,North Macedonia,Southern Europe,Europe,2004,5,24,0,29
8,Albania,Southern Europe,Europe,2004,4,33,0,37
20,Andorra,Southern Europe,Europe,2004,4,1,0,5
20,Andorra,Southern Europe,Europe,2010,4,4,0,8
31,Azerbaijan,Western Asia,Asia,2010,4,41,0,45
108,Burundi,Eastern Africa,Africa,2004,4,22,2,28
120,Cameroon,Middle Africa,Africa,2004,4,146,334,484
148,Chad,Middle Africa,Africa,2010,4,24,2,30
148,Chad,Middle Africa,Africa,2015,4,29,5,38
148,Chad,Middle Africa,Africa,2018,4,36,6,46
148,Chad,Middle Africa,Africa,2019,4,38,6,48
246,Finland,Northern Europe,Europe,2020,10,19,32,61
156,China,Eastern Asia,Asia,2004,4,326,443,773
174,Comoros,Eastern Africa,Africa,2004,4,18,5,27
196,Cyprus,Western Asia,Asia,2010,4,31,8,43
728,South Sudan,Eastern Africa,Africa,2020,1,42,18,61
226,Equatorial Guinea,Middle Africa,Africa,2018,4,86,95,185
226,Equatorial Guinea,Middle Africa,Africa,2019,4,88,98,190
308,Grenada,Caribbean,North America,2020,10,47,3,60
660,Anguilla,Caribbean,North America,2020,10,47,3,60
233,Estonia,Northern Europe,Europe,2004,4,8,0,12
266,Gabon,Middle Africa,Africa,2018,4,107,172,283
266,Gabon,Middle Africa,Africa,2019,4,106,181,291
634,Qatar,Western Asia,Asia,2021,13,47,0,60
533,Aruba,Caribbean,North America,2021,2,53,5,60
275,State of Palestine,Western Asia,Asia,2015,4,20,0,24
275,State of Palestine,Western Asia,Asia,2018,4,26,6,36
275,State of Palestine,Western Asia,Asia,2019,4,25,10,39
663,Saint Martin (French part),Caribbean,North America,2020,10,46,3,59
384,CÃ´te dÂ’Ivoire,Western Africa,Africa,2010,4,100,106,210
398,Kazakhstan,Central Asia,Asia,2004,4,48,1,53
398,Kazakhstan,Central Asia,Asia,2010,4,53,16,73
795,Turkmenistan,Central Asia,Asia,2020,7,48,4,59
410,Republic of Korea,Eastern Asia,Asia,2015,4,65,7,76
417,Kyrgyzstan,Central Asia,Asia,2015,4,23,14,41
417,Kyrgyzstan,Central Asia,Asia,2018,4,26,13,43
417,Kyrgyzstan,Central Asia,Asia,2019,4,26,13,43
570,Niue,Polynesia,Oceania,2021,31,27,1,59
434,Libya,Northern Africa,Africa,2018,4,56,5,65
434,Libya,Northern Africa,Africa,2019,4,57,8,69
438,Liechtenstein,Western Europe,Europe,2015,4,0,0,4
442,Luxembourg,Western Europe,Europe,2004,4,6,0,10
442,Luxembourg,Western Europe,Europe,2010,4,1,0,5
470,Malta,Southern Europe,Europe,2015,4,23,4,31
795,Turkmenistan,Central Asia,Asia,2021,7,48,4,59
531,CuraÃ§ao,Caribbean,North America,2020,11,43,4,58
516,Namibia,Southern Africa,Africa,2015,4,73,28,105
516,Namibia,Southern Africa,Africa,2018,4,85,27,116
516,Namibia,Southern Africa,Africa,2019,4,84,27,115
534,Sint Maarten (Dutch part),Caribbean,North America,2020,10,46,2,58
772,Tokelau,Polynesia,Oceania,2021,36,22,0,58
583,Micronesia (Fed. States of),Micronesia,Oceania,2004,4,22,4,30
646,Rwanda,Eastern Africa,Africa,2004,4,30,3,37
646,Rwanda,Eastern Africa,Africa,2018,4,52,41,97
646,Rwanda,Eastern Africa,Africa,2019,4,52,71,127
470,Malta,Southern Europe,Europe,2021,7,46,5,58
732,Western Sahara,Northern Africa,Africa,2020,3,55,0,58
678,Sao Tome and Principe,Middle Africa,Africa,2018,4,51,49,104
678,Sao Tome and Principe,Middle Africa,Africa,2019,4,51,49,104
414,Kuwait,Western Asia,Asia,2020,13,44,0,57
690,Seychelles,Eastern Africa,Africa,2004,4,35,45,84
694,Sierra Leone,Western Africa,Africa,2004,4,35,47,86
68,Bolivia (Plurin. State of),South America,South America,2015,3,114,99,216
68,Bolivia (Plurin. State of),South America,South America,2018,3,129,104,236
68,Bolivia (Plurin. State of),South America,South America,2019,3,129,112,244
659,Saint Kitts and Nevis,Caribbean,North America,2020,10,45,2,57
570,Niue,Polynesia,Oceania,2020,30,25,1,56
192,Cuba,Caribbean,North America,2004,3,106,163,272
204,Benin,Western Africa,Africa,2015,3,55,16,74
204,Benin,Western Africa,Africa,2018,3,70,19,92
204,Benin,Western Africa,Africa,2019,3,77,21,101
772,Tokelau,Polynesia,Oceania,2020,35,19,0,54
233,Estonia,Northern Europe,Europe,2010,3,8,0,11
266,Gabon,Middle Africa,Africa,2015,3,93,135,231
48,Bahrain,Western Asia,Asia,2021,13,40,0,53
652,Saint BarthÃ©lemy,Caribbean,North America,2021,11,40,2,53
324,Guinea,Western Africa,Africa,2004,3,42,22,67
364,Iran (Islamic Republic of),Southern Asia,Asia,2004,3,65,1,69
372,Ireland,Northern Europe,Europe,2004,3,18,1,22
400,Jordan,Western Asia,Asia,2004,3,27,0,30
408,Dem. People's Rep. Korea,Eastern Asia,Asia,2015,3,53,8,64
408,Dem. People's Rep. Korea,Eastern Asia,Asia,2018,3,60,17,80
408,Dem. People's Rep. Korea,Eastern Asia,Asia,2019,3,63,17,83
148,Chad,Middle Africa,Africa,2021,6,39,7,52
410,Republic of Korea,Eastern Asia,Asia,2010,3,58,3,64
417,Kyrgyzstan,Central Asia,Asia,2004,3,12,1,16
417,Kyrgyzstan,Central Asia,Asia,2010,3,23,14,40
574,Norfolk Island,Australia and New Zealand,Oceania,2021,23,26,2,51
418,Lao People's Dem. Rep.,South-eastern Asia,Asia,2010,3,107,22,132
426,Lesotho,Southern Africa,Africa,2015,3,10,4,17
426,Lesotho,Southern Africa,Africa,2018,3,13,4,20
426,Lesotho,Southern Africa,Africa,2019,3,13,4,20
430,Liberia,Western Africa,Africa,2004,3,45,46,94
470,Malta,Southern Europe,Europe,2004,3,22,0,25
470,Malta,Southern Europe,Europe,2010,3,20,3,26
478,Mauritania,Western Africa,Africa,2015,3,66,0,69
478,Mauritania,Western Africa,Africa,2018,3,85,0,88
478,Mauritania,Western Africa,Africa,2019,3,86,0,89
162,Christmas Island,Australia and New Zealand,Oceania,2021,20,29,2,51
417,Kyrgyzstan,Central Asia,Asia,2021,3,35,13,51
492,Monaco,Western Europe,Europe,2015,3,13,0,16
492,Monaco,Western Europe,Europe,2018,3,18,1,22
492,Monaco,Western Europe,Europe,2019,3,19,2,24
496,Mongolia,Eastern Asia,Asia,2004,3,36,0,39
496,Mongolia,Eastern Asia,Asia,2010,3,33,0,36
496,Mongolia,Eastern Asia,Asia,2015,3,33,0,36
496,Mongolia,Eastern Asia,Asia,2018,3,37,0,40
496,Mongolia,Eastern Asia,Asia,2019,3,37,2,42
574,Norfolk Island,Australia and New Zealand,Oceania,2020,23,25,2,50
498,Republic of Moldova,Eastern Europe,Europe,2010,3,24,0,27
524,Nepal,Southern Asia,Asia,2010,3,83,7,93
524,Nepal,Southern Asia,Asia,2015,3,85,17,105
524,Nepal,Southern Asia,Asia,2018,3,84,17,104
524,Nepal,Southern Asia,Asia,2019,3,85,19,107
634,Qatar,Western Asia,Asia,2020,13,37,0,50
233,Estonia,Northern Europe,Europe,2021,8,15,27,50
604,Peru,South America,South America,2010,3,274,274,551
470,Malta,Southern Europe,Europe,2020,6,38,5,49
732,Western Sahara,Northern Africa,Africa,2015,3,36,0,39
732,Western Sahara,Northern Africa,Africa,2018,3,48,0,51
732,Western Sahara,Northern Africa,Africa,2019,3,47,0,50
626,Timor-Leste,South-eastern Asia,Asia,2021,1,43,5,49
233,Estonia,Northern Europe,Europe,2020,7,15,26,48
760,Syrian Arab Republic,Western Asia,Asia,2004,3,26,0,29
762,Tajikistan,Central Asia,Asia,2015,3,26,12,41
762,Tajikistan,Central Asia,Asia,2018,3,32,12,47
762,Tajikistan,Central Asia,Asia,2019,3,32,13,48
148,Chad,Middle Africa,Africa,2020,4,38,6,48
762,Tajikistan,Central Asia,Asia,2020,3,32,13,48
768,Togo,Western Africa,Africa,2015,3,51,12,66
768,Togo,Western Africa,Africa,2018,3,70,12,85
768,Togo,Western Africa,Africa,2019,3,74,13,90
762,Tajikistan,Central Asia,Asia,2021,3,33,12,48
4,Afghanistan,Southern Asia,Asia,2021,2,38,8,48
860,Uzbekistan,Central Asia,Asia,2015,3,34,17,54
860,Uzbekistan,Central Asia,Asia,2018,3,43,16,62
860,Uzbekistan,Central Asia,Asia,2019,3,43,16,62
48,Bahrain,Western Asia,Asia,2020,13,34,0,47
166,Cocos (Keeling) Islands,Australia and New Zealand,Oceania,2021,21,26,0,47
4,Afghanistan,Southern Asia,Asia,2015,2,31,5,38
4,Afghanistan,Southern Asia,Asia,2018,2,34,5,41
4,Afghanistan,Southern Asia,Asia,2019,2,33,5,40
292,Gibraltar,Southern Europe,Europe,2021,6,40,1,47
162,Christmas Island,Australia and New Zealand,Oceania,2020,19,26,1,46
50,Bangladesh,Southern Asia,Asia,2010,2,104,16,122
104,Myanmar,South-eastern Asia,Asia,2004,2,107,38,147
612,Pitcairn,Polynesia,Oceania,2021,17,20,9,46
144,Sri Lanka,Southern Asia,Asia,2004,2,112,280,394
214,Dominican Republic,Caribbean,North America,2004,2,72,30,104
226,Equatorial Guinea,Middle Africa,Africa,2004,2,38,61,101
226,Equatorial Guinea,Middle Africa,Africa,2010,2,60,68,130
242,Fiji,Melanesia,Oceania,2004,2,33,66,101
270,Gambia,Western Africa,Africa,2015,2,48,5,55
270,Gambia,Western Africa,Africa,2018,2,63,5,70
270,Gambia,Western Africa,Africa,2019,2,68,6,76
748,Eswatini,Southern Africa,Africa,2021,2,29,15,46
275,State of Palestine,Western Asia,Asia,2010,2,16,0,18
292,Gibraltar,Southern Europe,Europe,2004,2,16,0,18
292,Gibraltar,Southern Europe,Europe,2010,2,20,0,22
332,Haiti,Caribbean,North America,2004,2,86,28,116
340,Honduras,Central America,North America,2004,2,93,111,206
368,Iraq,Western Asia,Asia,2004,2,33,0,35
372,Ireland,Northern Europe,Europe,2010,2,24,1,27
408,Dem. People's Rep. Korea,Eastern Asia,Asia,2010,2,44,6,52
426,Lesotho,Southern Africa,Africa,2010,2,10,4,16
275,State of Palestine,Western Asia,Asia,2021,3,31,11,45
612,Pitcairn,Polynesia,Oceania,2020,16,21,7,44
434,Libya,Northern Africa,Africa,2015,2,49,3,54
438,Liechtenstein,Western Europe,Europe,2010,2,0,0,2
474,Martinique,Caribbean,North America,2015,2,34,9,45
474,Martinique,Caribbean,North America,2018,2,37,9,48
474,Martinique,Caribbean,North America,2019,2,45,9,56
652,Saint BarthÃ©lemy,Caribbean,North America,2020,11,31,2,44
533,Aruba,Caribbean,North America,2020,2,37,5,44
417,Kyrgyzstan,Central Asia,Asia,2020,4,26,13,43
533,Aruba,Caribbean,North America,2015,2,25,2,29
533,Aruba,Caribbean,North America,2018,2,28,2,32
533,Aruba,Caribbean,North America,2019,2,33,3,38
496,Mongolia,Eastern Asia,Asia,2020,3,37,3,43
496,Mongolia,Eastern Asia,Asia,2021,2,37,4,43
558,Nicaragua,Central America,North America,2004,2,49,39,90
562,Niger,Western Africa,Africa,2010,2,22,2,26
562,Niger,Western Africa,Africa,2021,2,36,4,42
580,Northern Mariana Islands,Micronesia,Oceania,2004,2,22,4,28
591,Panama,Central America,North America,2004,2,113,195,310
440,Lithuania,Northern Europe,Europe,2020,8,18,15,41
604,Peru,South America,South America,2004,2,232,274,508
624,Guinea-Bissau,Western Africa,Africa,2015,2,59,5,66
624,Guinea-Bissau,Western Africa,Africa,2018,2,73,5,80
624,Guinea-Bissau,Western Africa,Africa,2019,2,75,10,87
492,Monaco,Western Europe,Europe,2021,4,35,2,41
646,Rwanda,Eastern Africa,Africa,2010,2,49,4,55
646,Rwanda,Eastern Africa,Africa,2015,2,51,8,61
654,Saint Helena,Western Africa,Africa,2004,2,32,26,60
654,Saint Helena,Western Africa,Africa,2010,2,31,27,60
678,Sao Tome and Principe,Middle Africa,Africa,2004,2,24,35,61
678,Sao Tome and Principe,Middle Africa,Africa,2010,2,33,35,70
716,Zimbabwe,Eastern Africa,Africa,2004,2,24,17,43
729,Sudan,Northern Africa,Africa,2004,2,36,17,55
626,Timor-Leste,South-eastern Asia,Asia,2020,1,35,5,41
762,Tajikistan,Central Asia,Asia,2004,2,20,2,24
762,Tajikistan,Central Asia,Asia,2010,2,24,14,40
776,Tonga,Polynesia,Oceania,2004,2,11,3,16
858,Uruguay,South America,South America,2015,2,79,22,103
858,Uruguay,South America,South America,2018,2,85,22,109
858,Uruguay,South America,South America,2019,2,86,22,110
748,Eswatini,Southern Africa,Africa,2020,0,28,13,41
887,Yemen,Western Asia,Asia,2004,2,34,159,195
4,Afghanistan,Southern Asia,Asia,2004,1,31,1,33
4,Afghanistan,Southern Asia,Asia,2010,1,31,2,34
44,Bahamas,Caribbean,North America,2004,1,36,5,42
64,Bhutan,Southern Asia,Asia,2004,1,40,7,48
64,Bhutan,Southern Asia,Asia,2010,1,50,8,59
64,Bhutan,Southern Asia,Asia,2015,1,52,18,71
64,Bhutan,Southern Asia,Asia,2018,1,51,43,95
64,Bhutan,Southern Asia,Asia,2019,1,55,43,99
166,Cocos (Keeling) Islands,Australia and New Zealand,Oceania,2020,20,20,0,40
428,Latvia,Northern Europe,Europe,2020,12,18,10,40
68,Bolivia (Plurin. State of),South America,South America,2004,1,79,70,150
68,Bolivia (Plurin. State of),South America,South America,2010,1,90,72,163
84,Belize,Central America,North America,2004,1,36,30,67
96,Brunei Darussalam,South-eastern Asia,Asia,2010,1,70,99,170
136,Cayman Islands,Caribbean,North America,2004,1,16,2,19
148,Chad,Middle Africa,Africa,2004,1,18,2,21
175,Mayotte,Eastern Africa,Africa,2004,1,6,0,7
178,Congo,Middle Africa,Africa,2004,1,29,35,65
204,Benin,Western Africa,Africa,2010,1,47,14,62
222,El Salvador,Central America,North America,2004,1,23,25,49
4,Afghanistan,Southern Asia,Asia,2020,2,33,5,40
266,Gabon,Middle Africa,Africa,2004,1,31,107,139
288,Ghana,Western Africa,Africa,2010,1,83,118,202
296,Kiribati,Micronesia,Oceania,2004,1,10,0,11
312,Guadeloupe,Caribbean,North America,2004,1,25,7,33
328,Guyana,South America,South America,2004,1,41,23,65
328,Guyana,South America,South America,2010,1,46,22,69
328,Guyana,South America,South America,2015,1,63,23,87
328,Guyana,South America,South America,2018,1,73,26,100
328,Guyana,South America,South America,2019,1,83,33,117
428,Latvia,Northern Europe,Europe,2021,12,18,10,40
440,Lithuania,Northern Europe,Europe,2021,8,17,15,40
344,"China, Hong Kong SAR",Eastern Asia,Asia,2004,1,32,6,39
384,CÃ´te dÂ’Ivoire,Western Africa,Africa,2004,1,61,105,167
408,Dem. People's Rep. Korea,Eastern Asia,Asia,2004,1,40,3,44
410,Republic of Korea,Eastern Asia,Asia,2004,1,54,0,55
422,Lebanon,Western Asia,Asia,2004,1,25,0,26
426,Lesotho,Southern Africa,Africa,2004,1,11,1,13
446,"China, Macao SAR",Eastern Asia,Asia,2015,1,10,0,11
446,"China, Macao SAR",Eastern Asia,Asia,2018,1,10,0,11
446,"China, Macao SAR",Eastern Asia,Asia,2019,1,15,0,16
275,State of Palestine,Western Asia,Asia,2020,4,25,10,39
352,Iceland,Northern Europe,Europe,2021,0,32,6,38
474,Martinique,Caribbean,North America,2004,1,20,8,29
474,Martinique,Caribbean,North America,2010,1,22,8,31
478,Mauritania,Western Africa,Africa,2004,1,25,0,26
478,Mauritania,Western Africa,Africa,2010,1,57,0,58
512,Oman,Western Asia,Asia,2004,1,48,6,55
516,Namibia,Southern Africa,Africa,2004,1,44,24,69
524,Nepal,Southern Asia,Asia,2004,1,69,7,77
533,Aruba,Caribbean,North America,2004,1,17,0,18
533,Aruba,Caribbean,North America,2010,1,20,1,22
562,Niger,Western Africa,Africa,2004,1,12,2,15
562,Niger,Western Africa,Africa,2015,1,27,3,31
562,Niger,Western Africa,Africa,2018,1,32,3,36
562,Niger,Western Africa,Africa,2019,1,32,4,37
562,Niger,Western Africa,Africa,2020,1,32,4,37
566,Nigeria,Western Africa,Africa,2004,1,61,170,232
584,Marshall Islands,Micronesia,Oceania,2004,1,12,0,13
292,Gibraltar,Southern Europe,Europe,2020,6,29,1,36
624,Guinea-Bissau,Western Africa,Africa,2004,1,17,4,22
626,Timor-Leste,South-eastern Asia,Asia,2015,1,19,1,21
626,Timor-Leste,South-eastern Asia,Asia,2018,1,24,1,26
626,Timor-Leste,South-eastern Asia,Asia,2019,1,31,3,35
854,Burkina Faso,Western Africa,Africa,2021,0,31,5,36
854,Burkina Faso,Western Africa,Africa,2020,1,30,5,36
630,Puerto Rico,Caribbean,North America,2004,1,44,52,97
630,Puerto Rico,Caribbean,North America,2010,1,49,53,103
674,San Marino,Southern Europe,Europe,2015,1,0,0,1
674,San Marino,Southern Europe,Europe,2018,1,0,0,1
674,San Marino,Southern Europe,Europe,2019,1,0,0,1
352,Iceland,Northern Europe,Europe,2020,0,30,6,36
498,Republic of Moldova,Eastern Europe,Europe,2021,6,27,2,35
682,Saudi Arabia,Western Asia,Asia,2004,1,37,3,41
686,Senegal,Western Africa,Africa,2010,1,72,9,82
702,Singapore,South-eastern Asia,Asia,2004,1,30,54,85
706,Somalia,Eastern Africa,Africa,2004,1,46,17,64
728,South Sudan,Eastern Africa,Africa,2018,1,36,16,53
728,South Sudan,Eastern Africa,Africa,2019,1,39,17,57
72,Botswana,Southern Africa,Africa,2021,0,32,3,35
492,Monaco,Western Europe,Europe,2020,4,28,2,34
732,Western Sahara,Northern Africa,Africa,2004,1,18,0,19
732,Western Sahara,Northern Africa,Africa,2010,1,38,0,39
740,Suriname,South America,South America,2010,1,38,26,65
740,Suriname,South America,South America,2015,1,49,26,76
740,Suriname,South America,South America,2018,1,57,27,85
740,Suriname,South America,South America,2019,1,57,28,86
498,Republic of Moldova,Eastern Europe,Europe,2020,6,25,2,33
72,Botswana,Southern Africa,Africa,2020,0,30,3,33
764,Thailand,South-eastern Asia,Asia,2004,1,136,84,221
768,Togo,Western Africa,Africa,2010,1,43,10,54
798,Tuvalu,Polynesia,Oceania,2004,1,7,0,8
818,Egypt,Northern Africa,Africa,2004,1,43,2,46
832,Jersey,Northern Europe,Europe,2015,1,2,0,3
832,Jersey,Northern Europe,Europe,2018,1,5,0,6
832,Jersey,Northern Europe,Europe,2019,1,6,0,7
234,Faroe Islands,Northern Europe,Europe,2021,0,27,5,32
112,Belarus,Eastern Europe,Europe,2021,11,15,5,31
854,Burkina Faso,Western Africa,Africa,2010,1,20,3,24
854,Burkina Faso,Western Africa,Africa,2015,1,25,3,29
854,Burkina Faso,Western Africa,Africa,2018,1,26,3,30
854,Burkina Faso,Western Africa,Africa,2019,1,28,4,33
260,French Southern Territories,Eastern Africa,Africa,2021,0,29,2,31
858,Uruguay,South America,South America,2004,1,48,1,50
858,Uruguay,South America,South America,2010,1,78,1,80
860,Uzbekistan,Central Asia,Asia,2004,1,29,1,31
860,Uzbekistan,Central Asia,Asia,2010,1,34,15,50
862,Venezuela (Boliv. Rep. of),South America,South America,2004,1,151,67,219
882,Samoa,Polynesia,Oceania,2004,1,15,2,18
896,Areas n.e.s,No Categorization,No Categorization,2015,1,1,0,2
896,Areas n.e.s,No Categorization,No Categorization,2018,1,5,0,6
896,Areas n.e.s,No Categorization,No Categorization,2019,1,7,,8
10,Antarctica,Antarctica,Antarctica,2004,0,8,0,8
10,Antarctica,Antarctica,Antarctica,2010,0,6,0,6
10,Antarctica,Antarctica,Antarctica,2015,0,6,0,6
10,Antarctica,Antarctica,Antarctica,2018,0,6,0,6
10,Antarctica,Antarctica,Antarctica,2019,0,6,0,6
112,Belarus,Eastern Europe,Europe,2020,10,15,5,30
238,Falkland Islands (Malvinas),South America,South America,2021,0,19,11,30
28,Antigua and Barbuda,Caribbean,North America,2004,0,18,4,22
48,Bahrain,Western Asia,Asia,2004,0,18,0,18
50,Bangladesh,Southern Asia,Asia,2004,0,73,12,85
52,Barbados,Caribbean,North America,2004,0,18,2,20
72,Botswana,Southern Africa,Africa,2004,0,15,0,15
72,Botswana,Southern Africa,Africa,2010,0,18,0,18
72,Botswana,Southern Africa,Africa,2015,0,22,2,24
72,Botswana,Southern Africa,Africa,2018,0,28,2,30
72,Botswana,Southern Africa,Africa,2019,0,30,3,33
304,Greenland,Northern America,North America,2021,0,27,3,30
234,Faroe Islands,Northern Europe,Europe,2020,0,24,5,29
74,Bouvet Island,South America,South America,2004,0,1,0,1
74,Bouvet Island,South America,South America,2010,0,2,0,2
74,Bouvet Island,South America,South America,2015,0,3,0,3
74,Bouvet Island,South America,South America,2018,0,3,0,3
74,Bouvet Island,South America,South America,2019,0,3,0,3
260,French Southern Territories,Eastern Africa,Africa,2020,0,28,1,29
304,Greenland,Northern America,North America,2020,0,24,3,27
86,British Indian Ocean Terr.,Eastern Africa,Africa,2004,0,6,1,7
92,British Virgin Islands,Caribbean,North America,2004,0,20,10,30
96,Brunei Darussalam,South-eastern Asia,Asia,2004,0,49,99,148
116,Cambodia,South-eastern Asia,Asia,2004,0,72,31,103
132,Cabo Verde,Western Africa,Africa,2004,0,21,2,23
132,Cabo Verde,Western Africa,Africa,2010,0,28,3,31
140,Central African Republic,Middle Africa,Africa,2004,0,15,15,30
140,Central African Republic,Middle Africa,Africa,2010,0,19,17,36
140,Central African Republic,Middle Africa,Africa,2015,0,32,22,54
140,Central African Republic,Middle Africa,Africa,2018,0,38,25,63
140,Central African Republic,Middle Africa,Africa,2019,0,40,26,66
446,"China, Macao SAR",Eastern Asia,Asia,2020,1,25,0,26
152,Chile,South America,South America,2004,0,83,40,123
158,Other non-specified areas,No Categorization,No Categorization,2004,0,79,78,157
162,Christmas Island,Australia and New Zealand,Oceania,2004,0,12,1,13
166,Cocos (Keeling) Islands,Australia and New Zealand,Oceania,2004,0,5,0,5
170,Colombia,South America,South America,2004,0,371,222,593
184,Cook Islands,Polynesia,Oceania,2004,0,22,1,23
196,Cyprus,Western Asia,Asia,2004,0,24,1,25
204,Benin,Western Africa,Africa,2004,0,17,14,31
212,Dominica,Caribbean,North America,2004,0,22,11,33
232,Eritrea,Eastern Africa,Africa,2004,0,31,3,34
234,Faroe Islands,Northern Europe,Europe,2004,0,11,0,11
234,Faroe Islands,Northern Europe,Europe,2010,0,13,0,13
234,Faroe Islands,Northern Europe,Europe,2015,0,14,0,14
234,Faroe Islands,Northern Europe,Europe,2018,0,22,1,23
234,Faroe Islands,Northern Europe,Europe,2019,0,23,4,27
446,"China, Macao SAR",Eastern Asia,Asia,2021,1,25,0,26
238,Falkland Islands (Malvinas),South America,South America,2020,0,18,6,24
238,Falkland Islands (Malvinas),South America,South America,2004,0,21,5,26
238,Falkland Islands (Malvinas),South America,South America,2010,0,18,5,23
238,Falkland Islands (Malvinas),South America,South America,2015,0,18,5,23
238,Falkland Islands (Malvinas),South America,South America,2018,0,17,5,22
238,Falkland Islands (Malvinas),South America,South America,2019,0,17,6,23
666,Saint Pierre and Miquelon,Northern America,North America,2021,0,23,0,23
426,Lesotho,Southern Africa,Africa,2021,2,14,5,21
239,South Georgia & Sandwich Is.,South America,South America,2004,0,12,0,12
239,South Georgia & Sandwich Is.,South America,South America,2010,0,10,0,10
239,South Georgia & Sandwich Is.,South America,South America,2015,0,9,0,9
239,South Georgia & Sandwich Is.,South America,South America,2018,0,9,0,9
239,South Georgia & Sandwich Is.,South America,South America,2019,0,9,0,9
426,Lesotho,Southern Africa,Africa,2020,2,13,4,19
666,Saint Pierre and Miquelon,Northern America,North America,2020,0,19,0,19
442,Luxembourg,Western Europe,Europe,2021,8,4,5,17
442,Luxembourg,Western Europe,Europe,2020,7,4,5,16
254,French Guiana,South America,South America,2004,0,33,16,49
254,French Guiana,South America,South America,2010,0,40,16,56
254,French Guiana,South America,South America,2015,0,51,16,67
254,French Guiana,South America,South America,2018,0,56,18,74
254,French Guiana,South America,South America,2019,0,59,18,77
20,Andorra,Southern Europe,Europe,2020,8,6,1,15
260,French Southern Territories,Eastern Africa,Africa,2004,0,17,0,17
260,French Southern Territories,Eastern Africa,Africa,2010,0,21,0,21
260,French Southern Territories,Eastern Africa,Africa,2015,0,22,0,22
260,French Southern Territories,Eastern Africa,Africa,2018,0,25,0,25
260,French Southern Territories,Eastern Africa,Africa,2019,0,28,1,29
832,Jersey,Northern Europe,Europe,2021,1,13,1,15
832,Jersey,Northern Europe,Europe,2020,1,12,1,14
262,Djibouti,Eastern Africa,Africa,2004,0,19,2,21
266,Gabon,Middle Africa,Africa,2010,0,84,120,204
270,Gambia,Western Africa,Africa,2004,0,17,4,21
270,Gambia,Western Africa,Africa,2010,0,39,4,43
275,State of Palestine,Western Asia,Asia,2004,0,4,0,4
288,Ghana,Western Africa,Africa,2004,0,43,117,160
304,Greenland,Northern America,North America,2004,0,11,1,12
304,Greenland,Northern America,North America,2010,0,13,1,14
304,Greenland,Northern America,North America,2015,0,16,1,17
304,Greenland,Northern America,North America,2018,0,24,1,25
304,Greenland,Northern America,North America,2019,0,24,1,25
20,Andorra,Southern Europe,Europe,2021,7,6,1,14
438,Liechtenstein,Western Europe,Europe,2020,6,2,5,13
308,Grenada,Caribbean,North America,2004,0,20,3,23
334,Heard Is. and McDonald Is.,Australia and New Zealand,Oceania,2004,0,12,0,12
334,Heard Is. and McDonald Is.,Australia and New Zealand,Oceania,2010,0,12,0,12
334,Heard Is. and McDonald Is.,Australia and New Zealand,Oceania,2015,0,12,0,12
334,Heard Is. and McDonald Is.,Australia and New Zealand,Oceania,2018,0,12,0,12
334,Heard Is. and McDonald Is.,Australia and New Zealand,Oceania,2019,0,12,0,12
334,Heard Is. and McDonald Is.,Australia and New Zealand,Oceania,2021,0,13,0,13
831,Guernsey,Northern Europe,Europe,2021,0,13,0,13
336,Holy See,Southern Europe,Europe,2010,0,1,0,1
336,Holy See,Southern Europe,Europe,2015,0,1,0,1
336,Holy See,Southern Europe,Europe,2018,0,1,0,1
336,Holy See,Southern Europe,Europe,2019,0,1,0,1
334,Heard Is. and McDonald Is.,Australia and New Zealand,Oceania,2020,0,12,0,12
438,Liechtenstein,Western Europe,Europe,2021,5,2,5,12
352,Iceland,Northern Europe,Europe,2004,0,15,0,15
352,Iceland,Northern Europe,Europe,2010,0,17,0,17
352,Iceland,Northern Europe,Europe,2015,0,21,0,21
352,Iceland,Northern Europe,Europe,2018,0,29,0,29
352,Iceland,Northern Europe,Europe,2019,0,29,2,31
744,Svalbard and Jan Mayen Is.,Northern Europe,Europe,2021,0,11,1,12
831,Guernsey,Northern Europe,Europe,2020,0,12,0,12
414,Kuwait,Western Asia,Asia,2004,0,20,0,20
418,Lao People's Dem. Rep.,South-eastern Asia,Asia,2004,0,72,19,91
434,Libya,Northern Africa,Africa,2004,0,24,1,25
434,Libya,Northern Africa,Africa,2010,0,42,2,44
446,"China, Macao SAR",Eastern Asia,Asia,2004,0,5,0,5
446,"China, Macao SAR",Eastern Asia,Asia,2010,0,9,0,9
462,Maldives,Southern Asia,Asia,2004,0,12,0,12
466,Mali,Western Africa,Africa,2004,0,19,6,25
466,Mali,Western Africa,Africa,2010,0,23,6,29
466,Mali,Western Africa,Africa,2015,0,31,8,39
466,Mali,Western Africa,Africa,2018,0,35,11,46
466,Mali,Western Africa,Africa,2019,0,37,24,61
744,Svalbard and Jan Mayen Is.,Northern Europe,Europe,2020,0,10,1,11
492,Monaco,Western Europe,Europe,2004,0,9,0,9
492,Monaco,Western Europe,Europe,2010,0,11,0,11
500,Montserrat,Caribbean,North America,2004,0,18,3,21
516,Namibia,Southern Africa,Africa,2010,0,66,26,92
520,Nauru,Micronesia,Oceania,2004,0,5,0,5
530,Netherlands Antilles [former],Western Europe,Europe,2004,0,26,2,28
548,Vanuatu,Melanesia,Oceania,2004,0,19,10,29
570,Niue,Polynesia,Oceania,2004,0,12,0,12
581,U.S. Minor Outlying islands,Micronesia,Oceania,2004,0,15,0,15
586,Pakistan,Southern Asia,Asia,2004,0,70,2,72
600,Paraguay,South America,South America,2004,0,40,10,50
600,Paraguay,South America,South America,2010,0,38,10,48
600,Paraguay,South America,South America,2015,0,39,19,58
600,Paraguay,South America,South America,2018,0,43,19,62
600,Paraguay,South America,South America,2019,0,44,20,64
624,Guinea-Bissau,Western Africa,Africa,2010,0,48,4,52
626,Timor-Leste,South-eastern Asia,Asia,2004,0,11,0,11
626,Timor-Leste,South-eastern Asia,Asia,2010,0,18,0,18
630,Puerto Rico,Caribbean,North America,2015,0,70,57,127
630,Puerto Rico,Caribbean,North America,2018,0,72,63,135
630,Puerto Rico,Caribbean,North America,2019,0,76,65,141
239,South Georgia & Sandwich Is.,South America,South America,2020,0,9,0,9
239,South Georgia & Sandwich Is.,South America,South America,2021,0,9,0,9
634,Qatar,Western Asia,Asia,2004,0,12,0,12
659,Saint Kitts and Nevis,Caribbean,North America,2004,0,17,2,19
660,Anguilla,Caribbean,North America,2004,0,15,3,18
662,Saint Lucia,Caribbean,North America,2004,0,23,6,29
666,Saint Pierre and Miquelon,Northern America,North America,2004,0,2,0,2
666,Saint Pierre and Miquelon,Northern America,North America,2010,0,4,0,4
666,Saint Pierre and Miquelon,Northern America,North America,2015,0,7,0,7
666,Saint Pierre and Miquelon,Northern America,North America,2018,0,14,0,14
666,Saint Pierre and Miquelon,Northern America,North America,2019,0,16,0,16
10,Antarctica,Antarctica,Antarctica,2021,0,8,0,8
833,Isle of Man,Northern Europe,Europe,2021,0,7,1,8
670,Saint Vincent & Grenadines,Caribbean,North America,2004,0,20,4,24
674,San Marino,Southern Europe,Europe,2010,0,0,0,0
686,Senegal,Western Africa,Africa,2004,0,40,7,47
704,Viet Nam,South-eastern Asia,Asia,2004,0,144,145,289
728,South Sudan,Eastern Africa,Africa,2015,0,26,16,42
740,Suriname,South America,South America,2004,0,32,27,59
744,Svalbard and Jan Mayen Is.,Northern Europe,Europe,2004,0,9,0,9
744,Svalbard and Jan Mayen Is.,Northern Europe,Europe,2010,0,3,0,3
744,Svalbard and Jan Mayen Is.,Northern Europe,Europe,2015,0,5,0,5
744,Svalbard and Jan Mayen Is.,Northern Europe,Europe,2018,0,9,0,9
744,Svalbard and Jan Mayen Is.,Northern Europe,Europe,2019,0,10,1,11
10,Antarctica,Antarctica,Antarctica,2020,0,6,0,6
833,Isle of Man,Northern Europe,Europe,2020,0,5,1,6
748,Eswatini,Southern Africa,Africa,2004,0,12,11,23
748,Eswatini,Southern Africa,Africa,2010,0,18,11,29
748,Eswatini,Southern Africa,Africa,2015,0,23,11,34
748,Eswatini,Southern Africa,Africa,2018,0,26,12,38
748,Eswatini,Southern Africa,Africa,2019,0,28,13,41
674,San Marino,Southern Europe,Europe,2021,1,3,0,4
768,Togo,Western Africa,Africa,2004,0,22,10,32
772,Tokelau,Polynesia,Oceania,2004,0,6,0,6
780,Trinidad and Tobago,Caribbean,North America,2004,0,32,1,33
784,United Arab Emirates,Western Asia,Asia,2004,0,23,0,23
796,Turks and Caicos Islands,Caribbean,North America,2004,0,18,2,20
831,Guernsey,Northern Europe,Europe,2010,0,2,0,2
831,Guernsey,Northern Europe,Europe,2015,0,2,0,2
831,Guernsey,Northern Europe,Europe,2018,0,5,0,5
831,Guernsey,Northern Europe,Europe,2019,0,6,0,6
674,San Marino,Southern Europe,Europe,2020,1,1,0,2
74,Bouvet Island,South America,South America,2020,0,2,0,2
832,Jersey,Northern Europe,Europe,2010,0,2,0,2
833,Isle of Man,Northern Europe,Europe,2010,0,2,0,2
833,Isle of Man,Northern Europe,Europe,2015,0,3,0,3
833,Isle of Man,Northern Europe,Europe,2018,0,3,0,3
833,Isle of Man,Northern Europe,Europe,2019,0,2,1,3
74,Bouvet Island,South America,South America,2021,0,2,0,2
336,Holy See,Southern Europe,Europe,2021,0,2,0,2
850,United States Virgin Islands,Caribbean,North America,2004,0,22,9,31
850,United States Virgin Islands,Caribbean,North America,2010,0,21,12,33
850,United States Virgin Islands,Caribbean,North America,2015,0,41,12,53
850,United States Virgin Islands,Caribbean,North America,2018,0,46,17,63
850,United States Virgin Islands,Caribbean,North America,2019,0,50,17,67
248,Ã…land Islands,Northern Europe,Europe,2020,0,0,1,1
336,Holy See,Southern Europe,Europe,2020,0,1,0,1
854,Burkina Faso,Western Africa,Africa,2004,0,9,2,11
248,Ã…land Islands,Northern Europe,Europe,2021,0,0,1,1
876,Wallis and Futuna Islands,Polynesia,Oceania,2004,0,12,1,13
896,Areas n.e.s,No Categorization,No Categorization,2004,0,1,0,1
896,Areas n.e.s,No Categorization,No Categorization,2010,0,1,0,1
580,Northern Mariana Islands,Micronesia,Oceania,2018,,40,5,102
